precinct,pri_dem_CLINTON,pri_dem_SANDERS,pri_rep_BUSH,pri_rep_CRUZ,pri_rep_KASICH,pri_rep_RUBIO,pri_rep_TRUMP,gen_dem_CLINTON,gen_rep_TRUMP,rep_primary_total,dem_primary_total,general_total
BeaverheadPRECINCT 01,27,44,10,18,30,8,78,175,203,144,71,378
BeaverheadPRECINCT 02,22,50,9,38,23,13,252,127,551,335,72,678
BeaverheadPRECINCT 03,36,33,11,35,35,18,269,158,507,368,69,665
BeaverheadPRECINCT 04,10,7,5,13,7,5,76,34,131,106,17,165
BeaverheadPRECINCT 05,1,1,2,7,5,2,56,9,99,72,2,108
BeaverheadPRECINCT 06,27,34,7,17,24,11,157,129,324,216,61,453
BeaverheadPRECINCT 07,11,13,3,16,18,7,120,40,231,164,24,271
BeaverheadPRECINCT 08,2,4,2,3,6,3,37,14,56,51,6,70
BeaverheadPRECINCT 09,15,29,14,12,10,7,143,87,300,186,44,387
BeaverheadPRECINCT 12,38,36,16,11,30,9,148,157,270,214,74,427
BeaverheadPRECINCT 14,27,41,3,12,13,6,94,125,225,128,68,350
BeaverheadPRECINCT 17,8,10,3,2,2,0,44,18,82,51,18,100
BeaverheadPRECINCT 19,2,7,0,4,4,2,67,14,92,77,9,106
BeaverheadPRECINCT 20,1,0,0,3,2,3,51,2,74,59,1,76
BeaverheadPRECINCT 21,11,6,4,7,3,3,55,25,117,72,17,142
BeaverheadPRECINCT 23,6,8,2,5,1,1,52,29,91,61,14,120
Big HornPRECINCT #1,8,11,2,5,1,2,46,56,93,56,19,149
Big HornPRECINCT #10,3,2,0,1,2,3,22,12,49,28,5,61
Big HornPRECINCT #14,18,16,0,0,0,1,12,70,51,13,34,121
Big HornPRECINCT #15,30,50,0,4,0,0,24,129,107,28,80,236
Big HornPRECINCT #17,32,34,1,5,3,3,83,116,200,95,66,316
Big HornPRECINCT #18,20,28,0,12,3,2,79,81,194,96,48,275
Big HornPRECINCT #19,34,55,5,16,1,5,122,172,269,149,89,441
Big HornPRECINCT #2,8,10,1,2,1,1,22,46,56,27,18,102
Big HornPRECINCT #21,54,35,1,1,4,0,24,228,93,30,89,321
Big HornPRECINCT #25,9,8,0,1,0,2,17,64,57,20,17,121
Big HornPRECINCT #26,23,37,0,6,1,2,15,224,73,24,60,297
Big HornPRECINCT #3,7,10,0,2,1,0,45,20,114,48,17,134
Big HornPRECINCT #4,5,5,0,5,1,0,30,13,60,36,10,73
Big HornPRECINCT #4N,5,10,2,3,0,1,58,16,124,64,15,140
Big HornPRECINCT #5,26,21,1,8,1,2,14,136,48,26,47,184
Big HornPRECINCT #6,4,6,0,1,0,0,22,14,50,23,10,64
Big HornPRECINCT #7,101,108,1,4,2,1,18,554,89,26,209,643
Big HornPRECINCT #8,10,15,0,2,1,2,45,46,98,50,25,144
Big HornPRECINCT #9,17,25,0,0,0,1,6,97,28,7,42,125
BlaineBELKNAP 3-32,49,73,1,0,0,0,13,300,35,14,122,335
BlaineCHINOOK 11-33,66,103,5,21,8,10,138,172,381,182,169,553
BlaineHARLEM 8-32,52,52,0,7,1,6,45,152,113,59,104,265
BlaineHARLEM 9-32,18,24,0,0,0,0,2,126,12,2,42,138
BlaineHAYS 15-32,51,91,2,1,0,0,8,350,43,11,142,393
BlaineNO CHINOOK 13-33,7,9,0,4,3,0,38,16,97,45,16,113
BlaineSO CHINOOK 10-32,29,39,6,15,6,2,135,54,370,164,68,424
BlaineTURNER 1-33,8,15,2,4,7,2,109,32,217,124,23,249
BroadwaterPRECINCT 1,42,74,5,21,19,5,203,150,484,253,116,634
BroadwaterPRECINCT 11,41,49,4,29,11,9,255,100,513,308,90,613
BroadwaterPRECINCT 12,46,53,15,27,12,20,200,132,485,274,99,617
BroadwaterPRECINCT 13,18,36,7,40,3,6,200,86,532,256,54,618
BroadwaterPRECINCT 7,43,45,10,26,9,7,147,105,334,199,88,439
CarbonP 1,41,43,2,16,8,8,152,100,402,186,84,502
CarbonP 10,60,82,1,11,10,3,45,221,161,70,142,382
CarbonP 11,139,116,4,6,12,3,210,400,454,235,255,854
CarbonP 15,48,37,4,23,6,4,165,102,424,202,85,526
CarbonP 16,30,24,2,9,10,5,98,86,202,124,54,288
CarbonP 2,30,24,1,12,5,2,68,73,178,88,54,251
CarbonP 3,25,30,2,22,10,14,174,104,461,222,55,565
CarbonP 4,22,28,2,10,3,4,86,65,227,105,50,292
CarbonP 5,22,35,2,20,5,3,112,50,280,142,57,330
CarbonP 6,29,35,1,10,6,3,99,72,217,119,64,289
CarbonP 7,31,36,4,24,12,6,166,111,379,212,67,490
CarbonP 8,78,96,2,4,10,9,93,245,223,118,174,468
CarbonP 9,61,103,1,6,3,2,47,199,140,59,164,339
CarterPRECINCT #1 ALZADA,2,0,1,17,3,0,55,6,101,76,2,107
CarterPRECINCT #13 EKALAKA,13,20,3,21,6,4,94,32,170,128,33,202
CarterPRECINCT #14 RURAL EKALAKA,6,6,5,26,13,9,176,28,343,229,12,371
CarterPRECINCT #3 HAMMOND,0,0,1,4,1,1,24,4,64,31,0,68
CascadeP19A1,33,29,0,11,9,0,138,94,309,158,62,403
CascadeP19A2,86,65,8,72,42,14,304,197,676,440,151,873
CascadeP19A3,29,28,3,12,8,4,141,73,280,168,57,353
CascadeP19A4,45,52,3,16,17,1,135,139,272,172,97,411
CascadeP19B1,3,4,0,5,2,2,28,12,55,37,7,67
CascadeP19B2,114,91,6,18,30,14,341,271,692,409,205,963
CascadeP19C,63,45,6,18,16,6,183,151,417,229,108,568
CascadeP19D,67,45,8,12,14,6,121,128,289,161,112,417
CascadeP19E,5,4,4,8,10,6,116,88,183,144,9,271
CascadeP20A,550,376,44,110,226,57,1312,1385,2726,1749,926,4111
CascadeP20B,190,83,12,25,50,29,405,456,799,521,273,1255
CascadeP21A,656,487,22,80,71,37,915,1549,2419,1125,1143,3968
CascadeP21B,58,54,1,5,3,2,70,141,220,81,112,361
CascadeP22A,472,354,12,64,35,14,585,1130,1492,710,826,2622
CascadeP22B.,111,98,5,32,14,11,289,301,671,351,209,972
CascadeP22C,2,3,0,0,1,2,16,12,27,19,5,39
CascadeP23,639,426,28,95,57,28,721,1534,1798,929,1065,3332
CascadeP24,655,536,30,95,66,38,774,1599,2024,1003,1191,3623
CascadeP25,563,502,13,84,67,28,716,1533,2027,908,1065,3560
CascadeP26A,400,345,17,54,37,14,487,986,1249,609,745,2235
CascadeP26B,9,28,0,5,1,1,26,101,200,33,37,301
CascadeP27,68,40,5,14,10,4,211,194,456,244,108,650
CascadeP30,33,49,5,12,9,7,174,101,351,207,82,452
ChouteauBIG SANDY 8,28,22,3,15,5,2,76,62,187,101,50,249
ChouteauBIG SANDY 9,32,19,9,19,12,5,129,59,263,174,51,322
ChouteauCARTER 4,17,12,3,6,11,5,111,56,181,136,29,237
ChouteauFORT BENTON 1,55,30,6,13,18,7,150,135,285,194,85,420
ChouteauFORT BENTON 2,52,37,6,19,22,3,133,158,269,183,89,427
ChouteauGERALDINE 3,26,25,2,8,8,6,115,75,198,139,51,273
ChouteauHIGHWOOD 6,28,13,3,9,16,6,94,52,202,128,41,254
ChouteauLOMA 7,7,9,4,5,3,1,50,20,90,63,16,110
ChouteauROCKY BOY 5,22,15,0,0,0,0,2,115,4,2,37,119
CusterCCDHS,100,79,8,19,20,12,239,236,627,298,179,863
CusterHIGHLAND PARK SCH,134,82,7,38,30,25,311,314,835,411,216,1149
CusterISMAY CHURCH,0,1,0,0,0,1,23,1,32,24,1,33
CusterJEFFERSON SCH,109,89,6,19,10,11,273,265,771,319,198,1036
CusterKINSEY,16,21,0,9,4,0,45,39,124,58,37,163
CusterKIRCHER,26,14,1,3,1,4,48,46,126,57,40,172
CusterKNOWLTON SCH,0,2,2,5,1,2,21,3,51,31,2,54
CusterNAT'L GUARD,4,12,1,2,0,5,62,21,123,70,16,144
CusterRIVERVIEW SCHOOL,1,0,2,0,0,1,17,1,26,20,1,27
CusterS-H SCHOOL,3,3,1,5,2,1,32,8,83,41,6,91
CusterSHEFFIELD MOON,5,14,2,6,6,3,98,31,242,115,19,273
CusterSPRING CREEK SCH,0,0,0,5,0,1,26,0,46,32,0,46
CusterSY SCHOOL,2,1,0,1,2,4,8,2,26,15,3,28
CusterWASHINGTON SCH,76,70,6,13,8,6,167,209,545,200,146,754
DanielsPRECINCT #2,11,6,2,3,7,1,47,25,102,60,17,127
DanielsPRECINCT #3,10,14,1,10,9,4,121,36,243,145,24,279
DanielsPRECINCT #5,23,14,2,6,16,3,105,58,212,132,37,270
DanielsPRECINCT #6,21,10,1,5,11,6,67,49,173,90,31,222
DawsonPRECINCT 01,21,30,3,9,21,4,96,83,246,133,51,329
DawsonPRECINCT 02,25,31,4,15,18,6,187,94,371,230,56,465
DawsonPRECINCT 03,47,47,14,32,42,10,295,185,565,393,94,750
DawsonPRECINCT 04,27,29,5,14,14,7,128,106,302,168,56,408
DawsonPRECINCT 05,19,7,2,8,6,7,112,39,228,135,26,267
DawsonPRECINCT 06,40,35,10,37,28,17,391,106,736,483,75,842
DawsonPRECINCT 07,49,55,11,43,24,8,477,174,872,563,104,1046
Deer LodgePRECINCT 1-77E,119,114,1,6,3,1,57,260,157,68,233,417
Deer LodgePRECINCT 1-77W,148,111,4,10,6,4,99,302,195,123,259,497
Deer LodgePRECINCT 1-78,22,12,1,1,1,1,20,44,41,24,34,85
Deer LodgePRECINCT 2-77E,71,54,0,4,0,1,35,159,104,40,125,263
Deer LodgePRECINCT 2-77W,96,66,0,1,2,2,43,185,123,48,162,308
Deer LodgePRECINCT 2-78,15,9,0,4,0,1,11,35,25,16,24,60
Deer LodgePRECINCT 3-77E,68,59,1,8,1,2,45,144,124,57,127,268
Deer LodgePRECINCT 3-77W,59,57,0,4,0,0,33,145,114,37,116,259
Deer LodgePRECINCT 3-78,26,18,0,4,3,2,16,66,47,25,44,113
Deer LodgePRECINCT 4-77,17,9,0,1,1,0,39,27,59,41,26,86
Deer LodgePRECINCT 4-78E,52,53,0,7,1,3,62,104,143,73,105,247
Deer LodgePRECINCT 4-78W,38,41,3,11,4,1,70,98,156,89,79,254
Deer LodgePRECINCT 5-77N,140,111,2,5,7,5,123,266,268,142,251,534
Deer LodgePRECINCT 5-77S,119,83,0,8,2,6,94,223,207,110,202,430
FallonPRECINCT 1,11,9,7,15,10,13,201,47,341,246,20,388
FallonPRECINCT 2,11,9,4,26,13,8,177,52,336,228,20,388
FallonPRECINCT 3,12,1,5,28,9,6,220,40,391,268,13,431
FallonPRECINCT 4,0,2,1,12,15,7,136,15,211,171,2,226
FergusPREC 10,36,25,8,17,7,5,82,91,207,119,61,298
FergusPREC 11,44,36,6,10,15,4,124,132,288,159,80,420
FergusPREC 12,3,2,0,6,6,2,34,15,65,48,5,80
FergusPREC 13,51,30,6,34,16,9,163,125,352,228,81,477
FergusPREC 14,25,15,9,14,11,8,121,61,248,163,40,309
FergusPREC 16,10,14,3,14,11,6,102,27,196,136,24,223
FergusPREC 17,37,34,3,20,14,4,149,100,304,190,71,404
FergusPREC 18,4,2,0,6,1,1,102,14,165,110,6,179
FergusPREC 2,44,64,6,26,30,13,322,157,643,397,108,800
FergusPREC 3,22,17,7,15,19,8,140,59,313,189,39,372
FergusPREC 4,19,12,3,21,14,13,123,42,253,174,31,295
FergusPREC 5,11,15,0,14,3,6,128,34,286,151,26,320
FergusPREC 6,42,28,2,22,13,3,106,134,239,146,70,373
FergusPREC 7,15,20,3,16,10,6,74,77,233,109,35,310
FergusPREC 8,18,20,3,11,7,1,103,58,239,125,38,297
FergusPREC 9,34,24,1,10,24,4,109,76,238,148,58,314
FlatheadPRECINCT 1,38,70,1,14,9,8,98,184,373,130,108,557
FlatheadPRECINCT 11,73,75,4,31,21,12,330,196,758,398,148,954
FlatheadPRECINCT 13,88,103,7,34,48,14,448,350,962,551,191,1312
FlatheadPRECINCT 14,32,44,1,18,10,1,180,135,435,210,76,570
FlatheadPRECINCT 15,35,53,2,28,5,3,259,168,718,297,88,886
FlatheadPRECINCT 16,79,152,4,17,15,6,175,318,526,217,231,844
FlatheadPRECINCT 17,43,40,0,3,3,3,54,125,144,63,83,269
FlatheadPRECINCT 18,83,143,5,33,15,10,336,400,882,399,226,1282
FlatheadPRECINCT 19,39,54,7,32,15,7,255,166,763,316,93,929
FlatheadPRECINCT 2,65,103,3,11,9,8,142,318,451,173,168,769
FlatheadPRECINCT 20,183,311,10,32,36,13,240,851,615,331,494,1466
FlatheadPRECINCT 21,38,70,5,30,17,4,212,180,650,268,108,830
FlatheadPRECINCT 23,62,93,4,16,16,5,217,233,519,258,155,752
FlatheadPRECINCT 24,19,41,3,18,11,4,253,92,570,289,60,662
FlatheadPRECINCT 25,67,71,9,32,12,8,317,209,806,378,138,1015
FlatheadPRECINCT 26,36,34,1,22,9,7,182,124,472,221,70,596
FlatheadPRECINCT 29,75,71,11,20,48,20,399,282,1039,498,146,1321
FlatheadPRECINCT 3,64,126,4,21,21,6,172,316,493,224,190,809
FlatheadPRECINCT 31,154,172,22,54,56,32,497,572,1358,661,326,1930
FlatheadPRECINCT 32,43,115,6,20,10,6,153,265,483,195,158,748
FlatheadPRECINCT 33,17,28,1,4,4,2,102,75,272,113,45,347
FlatheadPRECINCT 34,94,89,8,58,44,15,448,331,1037,573,183,1368
FlatheadPRECINCT 35,93,149,4,31,22,7,286,378,813,350,242,1191
FlatheadPRECINCT 36,69,108,7,47,46,23,455,335,1157,578,177,1492
FlatheadPRECINCT 37,82,172,8,50,23,15,382,412,1252,478,254,1664
FlatheadPRECINCT 38,158,132,8,56,42,11,478,462,1154,595,290,1616
FlatheadPRECINCT 39,59,89,2,8,9,4,159,258,368,182,148,626
FlatheadPRECINCT 4,90,140,5,17,24,9,167,350,519,222,230,869
FlatheadPRECINCT 41,134,147,14,27,64,13,410,476,906,528,281,1382
FlatheadPRECINCT 42,90,107,6,47,28,23,429,325,1067,533,197,1392
FlatheadPRECINCT 43,97,176,5,46,35,17,444,400,1168,547,273,1568
FlatheadPRECINCT 44,117,155,5,45,39,9,326,460,757,424,272,1217
FlatheadPRECINCT 45,132,147,5,12,58,7,215,587,565,297,279,1152
FlatheadPRECINCT 47,118,229,2,12,27,5,115,669,367,161,347,1036
FlatheadPRECINCT 48,80,68,4,25,27,7,210,281,516,273,148,797
FlatheadPRECINCT 49,105,152,8,16,48,14,202,450,476,288,257,926
FlatheadPRECINCT 5,69,84,7,23,22,8,288,270,777,348,153,1047
FlatheadPRECINCT 50,42,63,4,34,11,14,302,170,824,365,105,994
FlatheadPRECINCT 6,179,142,10,78,84,27,702,633,1547,901,321,2180
FlatheadPRECINCT 7,74,83,3,27,26,9,248,254,697,313,157,951
FlatheadPRECINCT 8,48,50,2,29,17,6,263,151,588,317,98,739
FlatheadPRECINCT 89,22,36,1,13,6,3,165,82,396,188,58,478
GallatinPCT 59A,58,50,1,5,7,4,63,179,130,80,108,309
GallatinPCT 61A,300,281,7,45,43,14,314,881,745,423,581,1626
GallatinPCT 61B,271,291,7,68,37,15,299,842,787,426,562,1629
GallatinPCT 61C,344,416,10,18,23,13,132,1147,371,196,760,1518
GallatinPCT 61D,333,312,20,51,65,23,311,976,701,470,645,1677
GallatinPCT 62A,274,359,3,15,31,4,60,1109,248,113,633,1357
GallatinPCT 62B,217,325,12,20,16,6,81,956,302,135,542,1258
GallatinPCT 62C,398,282,14,36,64,26,234,1015,505,374,680,1520
GallatinPCT 62D,331,338,18,64,63,22,290,1142,866,457,669,2008
GallatinPCT 63A,178,326,11,54,34,16,262,895,802,377,504,1697
GallatinPCT 63B,22,140,0,5,5,6,19,637,440,35,162,1077
GallatinPCT 63C,166,361,9,50,26,18,175,956,609,278,527,1565
GallatinPCT 64A,78,164,2,15,17,4,173,327,403,211,242,730
GallatinPCT 64B,182,231,4,14,29,7,173,746,521,227,413,1267
GallatinPCT 64C,200,210,14,48,53,21,411,676,1036,547,410,1712
GallatinPCT 64D,181,304,17,113,63,27,554,799,1489,774,485,2288
GallatinPCT 65A,182,481,5,24,22,7,164,1060,503,222,663,1563
GallatinPCT 65B,217,358,8,34,26,17,232,1072,770,317,575,1842
GallatinPCT 65C,261,345,13,55,40,20,294,1205,1034,422,606,2239
GallatinPCT 66A,206,379,7,37,37,21,216,1071,713,318,585,1784
GallatinPCT 66B,227,455,7,45,20,18,171,1046,549,261,682,1595
GallatinPCT 66C,261,495,3,21,12,5,100,1329,317,141,756,1646
GallatinPCT 67A,154,190,9,43,49,14,296,484,715,411,344,1199
GallatinPCT 67B,117,244,15,85,28,29,311,606,1081,468,361,1687
GallatinPCT 67C,89,212,14,57,34,31,338,427,1036,474,301,1463
GallatinPCT 68A,173,184,16,83,66,45,503,599,1268,713,357,1867
GallatinPCT 68B,93,144,13,51,23,14,224,406,864,325,237,1270
GallatinPCT 68C,87,119,23,85,32,11,387,325,1157,538,206,1482
GallatinPCT 69A,126,182,12,52,31,19,393,367,995,507,308,1362
GallatinPCT 69B,69,73,19,129,60,39,430,220,1079,677,142,1299
GallatinPCT 69C,96,143,20,89,42,18,426,362,1003,595,239,1365
GallatinPCT 69D,111,149,11,47,39,17,348,384,763,462,260,1147
GarfieldPRECINCT 01,5,12,4,23,10,4,232,21,406,273,17,427
GarfieldPRECINCT 07,1,2,0,6,3,6,31,4,80,46,3,84
GarfieldPRECINCT 14,1,2,1,3,1,4,48,4,87,57,3,91
GarfieldPRECINCT 19,2,1,0,8,1,1,47,5,80,57,3,85
GlacierPCT 01,44,68,2,8,3,4,89,108,321,106,112,429
GlacierPCT 02,39,60,1,5,2,2,52,91,202,62,99,293
GlacierPCT 03,31,54,0,3,2,2,63,101,171,70,85,272
GlacierPCT 04,16,44,0,3,0,0,34,60,128,37,60,188
GlacierPCT 05,48,96,2,8,1,2,93,133,325,106,144,458
GlacierPCT 06,7,12,0,2,0,0,21,15,55,23,19,70
GlacierPCT 07,14,9,0,0,0,0,1,28,5,1,23,33
GlacierPCT 08,105,107,1,0,1,0,5,403,27,7,212,430
GlacierPCT 09,310,315,3,7,1,2,17,967,125,30,625,1092
GlacierPCT 10,77,94,0,1,4,1,15,240,56,21,171,296
GlacierPCT 11,37,36,0,1,0,0,8,76,39,9,73,115
GlacierPCT 12,75,50,1,2,0,0,5,188,16,8,125,204
GlacierPCT 13,50,65,0,1,0,0,7,199,21,8,115,220
GlacierPCT 15,39,53,0,0,0,2,19,139,80,21,92,219
GlacierPCT 19,47,39,0,2,2,0,1,137,28,5,86,165
GlacierPCT 21C,37,38,1,2,0,0,4,236,21,7,75,257
Golden ValleyLAVINA,6,15,0,14,6,1,101,31,187,122,21,218
Golden ValleyRYEGATE,21,14,2,9,9,3,102,40,178,125,35,218
GranitePRECINCT #1,30,65,3,9,9,1,94,123,260,116,95,383
GranitePRECINCT #10,19,52,3,25,7,3,146,91,347,184,71,438
GranitePRECINCT #2,59,70,4,17,18,9,147,183,336,195,129,519
GranitePRECINCT #9,30,29,4,8,12,7,100,75,249,131,59,324
HillPRECINCT #01,72,110,4,15,8,9,117,241,318,153,182,559
HillPRECINCT #02,58,52,2,3,4,1,52,136,169,62,110,305
HillPRECINCT #03,81,71,7,17,7,5,122,183,319,158,152,502
HillPRECINCT #07,89,96,3,11,15,5,133,230,369,167,185,599
HillPRECINCT #08,102,71,5,11,17,3,127,195,337,163,173,532
HillPRECINCT #09,99,57,2,6,14,4,85,201,245,111,156,446
HillPRECINCT #10,31,46,3,1,4,8,49,127,157,65,77,284
HillPRECINCT #13,27,40,1,5,2,1,50,79,129,59,67,208
HillPRECINCT #14,23,40,1,12,2,3,110,65,262,128,63,327
HillPRECINCT #15,24,36,1,4,5,0,60,63,181,70,60,244
HillPRECINCT #16,28,21,2,11,4,1,73,64,181,91,49,245
HillPRECINCT #18,11,17,2,0,0,0,10,80,31,12,28,111
HillPRECINCT #20,28,27,5,16,8,3,88,51,179,120,55,230
HillPRECINCT #21,15,20,1,1,8,1,47,35,91,58,35,126
HillPRECINCT #22,36,22,10,1,5,2,98,75,170,116,58,245
HillPRECINCT #25,65,73,1,7,7,6,126,140,332,147,138,472
HillPRECINCT #28,79,77,0,0,0,0,0,406,8,0,156,414
Jefferson01-71,60,74,3,36,14,9,255,168,613,317,134,781
Jefferson02-75,80,109,8,54,21,13,274,210,689,370,189,899
Jefferson03-75,7,10,0,1,1,0,16,18,35,18,17,53
Jefferson04-75,116,127,7,29,13,8,270,304,594,327,243,898
Jefferson05-75,17,17,0,6,0,1,37,48,90,44,34,138
Jefferson06-75,36,27,2,12,8,2,111,104,278,135,63,382
Jefferson07-75,109,135,3,20,18,6,180,301,481,227,244,782
Jefferson08-75,63,54,1,10,5,2,107,173,283,125,117,456
Jefferson09-75,121,126,5,43,31,13,196,317,549,288,247,866
Jefferson10-75,107,109,4,31,27,13,205,355,565,280,216,920
Lewis & ClarkPCT 01,0,114,0,39,15,13,274,264,729,341,114,993
Lewis & ClarkPCT 02,0,126,0,26,19,16,281,334,707,342,126,1041
Lewis & ClarkPCT 03,0,143,0,19,14,11,231,345,625,275,143,970
Lewis & ClarkPCT 04,0,95,0,35,20,12,208,319,565,275,95,884
Lewis & ClarkPCT 05,0,225,0,13,16,4,94,548,343,127,225,891
Lewis & ClarkPCT 06,0,204,0,38,18,16,223,478,606,295,204,1084
Lewis & ClarkPCT 07,241,241,0,26,24,15,157,573,362,222,482,935
Lewis & ClarkPCT 08,449,368,0,15,31,18,144,980,324,208,817,1304
Lewis & ClarkPCT 09,306,255,0,42,41,28,144,758,445,255,561,1203
Lewis & ClarkPCT 10,142,140,0,64,31,15,403,391,996,513,282,1387
Lewis & ClarkPCT 11,143,140,0,41,19,17,242,390,708,319,283,1098
Lewis & ClarkPCT 12,63,88,0,27,4,5,180,194,468,216,151,662
Lewis & ClarkPCT 13,519,463,0,20,47,15,201,1213,514,283,982,1727
Lewis & ClarkPCT 14,313,318,0,3,9,2,53,805,194,67,631,999
Lewis & ClarkPCT 15,92,147,0,17,7,2,136,332,413,162,239,745
Lewis & ClarkPCT 16,59,67,0,6,16,8,59,204,211,89,126,415
Lewis & ClarkPCT 16A,39,17,0,8,8,3,27,85,64,46,56,149
Lewis & ClarkPCT 16B,132,85,0,10,11,6,94,316,252,121,217,568
Lewis & ClarkPCT 17,246,326,0,23,14,6,86,784,268,129,572,1052
Lewis & ClarkPCT 18,182,143,0,21,37,14,198,451,513,270,325,964
Lewis & ClarkPCT 19,77,79,0,24,13,2,145,211,487,184,156,698
Lewis & ClarkPCT 20,142,166,0,32,18,9,240,392,633,299,308,1025
Lewis & ClarkPCT 21,120,127,0,48,25,16,271,327,765,360,247,1092
Lewis & ClarkPCT 22,159,136,0,13,9,5,42,422,195,69,295,617
Lewis & ClarkPCT 23,136,158,0,38,34,20,218,373,624,310,294,997
Lewis & ClarkPCT 24,265,202,0,43,38,20,216,627,616,317,467,1243
Lewis & ClarkPCT 25,171,234,0,25,13,11,123,552,405,172,405,957
Lewis & ClarkPCT 26,248,289,0,47,42,22,329,709,823,440,537,1532
Lewis & ClarkPCT 27,105,146,0,63,27,12,292,382,975,394,251,1357
Lewis & ClarkPCT 28,89,121,0,56,16,14,280,281,741,366,210,1022
Lewis & ClarkPCT 29,59,70,0,19,15,3,120,160,268,157,129,428
Lewis & ClarkPCT 30,19,16,0,6,4,2,61,47,114,73,35,161
Lewis & ClarkPCT 31,60,54,0,14,19,7,237,114,450,277,114,564
Lewis & ClarkPCT 32,3,5,0,4,3,2,44,8,66,53,8,74
Lewis & ClarkPCT 33,23,35,0,10,9,2,108,64,248,129,58,312
Lewis & ClarkPCT 33A,2,4,0,6,0,1,29,5,48,36,6,53
Lewis & ClarkPCT 33B,16,22,0,9,5,1,53,40,130,68,38,170
Liberty#1 Precinct - West,16,12,2,4,10,4,130,42,226,150,28,268
Liberty#2 Precinct - North,26,20,7,15,11,0,87,66,159,120,46,225
Liberty#3 Precinct - South,18,24,5,12,11,3,82,57,153,113,42,210
Liberty#4 Precinct - Joplin,18,18,6,11,6,4,88,41,160,115,36,201
LincolnCITY OF LIBBY,126,118,7,17,21,7,333,312,726,385,244,1038
LincolnEUREKA RURAL,90,131,10,31,17,24,550,320,1250,632,221,1570
LincolnFORTINE,15,39,3,6,4,1,143,80,344,157,54,424
LincolnLIBBY EAST,44,38,4,19,5,2,282,97,537,312,82,634
LincolnLIBBY NORTH,46,80,6,18,21,8,294,171,578,347,126,749
LincolnLIBBY WEST,64,79,3,38,19,9,378,173,800,447,143,973
LincolnLIBBY/PLUMMER,91,93,11,37,24,5,303,245,657,380,184,902
LincolnMC CORMICK,21,31,2,7,6,2,80,65,184,97,52,249
LincolnTOWN OF EUREKA,31,39,2,12,9,2,137,91,339,162,70,430
LincolnTREGO,19,23,0,5,2,1,88,67,214,96,42,281
LincolnTROY COMBINED,41,64,5,10,1,4,107,122,260,127,105,382
LincolnTROY NORTH,15,16,0,7,0,2,82,61,184,91,31,245
LincolnTROY RURAL,54,85,2,14,10,7,253,202,544,286,139,746
LincolnYAAK,11,11,0,12,1,0,45,35,112,58,22,147
MadisonALDER - WARD 2,15,8,2,6,8,3,73,36,145,92,23,181
MadisonENNIS - RURAL,124,106,11,51,55,13,423,458,1111,553,230,1569
MadisonENNIS - TOWN,34,40,11,15,14,12,88,158,287,140,74,445
MadisonHARRISON - WARD 2,18,27,5,20,6,6,107,64,250,144,45,314
MadisonJEFFERSON ISLAND - WARD 1,15,18,3,17,6,8,62,36,161,96,33,197
MadisonSHERIDAN,48,96,8,42,61,17,359,210,702,487,144,912
MadisonTWIN BRIDGES,40,44,8,13,37,7,246,152,539,311,84,691
MadisonVIRGINIA CITY - WARD 1,18,22,0,4,7,2,54,66,102,67,40,168
McConePRECINCT 27,23,14,0,8,7,4,98,49,212,117,37,261
McConePRECINCT 4,22,26,1,10,5,3,159,59,367,178,48,426
McConePRECINCT 8,20,18,0,20,4,3,153,46,283,180,38,329
MeagherPrecinct 5,56,58,9,35,34,10,396,193,729,484,114,922
MineralALBERTON,23,66,3,5,9,3,77,115,208,97,89,323
MineralST. REGIS,34,25,6,16,10,3,114,80,230,149,59,310
MineralSUPERIOR_24,26,28,4,6,8,5,40,57,98,63,54,155
MineralSUPERIOR_25,37,39,5,26,14,13,151,113,289,209,76,402
MineralSUPERIOR_30,47,47,6,16,7,15,199,133,385,243,94,518
MineralWEST END,7,11,0,6,0,1,59,21,120,66,18,141
MissoulaBONNER 89,22,23,0,2,6,1,26,57,65,35,45,122
MissoulaBONNER 92,138,281,6,31,13,4,239,527,679,293,419,1206
MissoulaCHIEF CHARLO 90,195,243,3,28,23,17,171,660,522,242,438,1182
MissoulaCLINTON 89,47,71,2,14,3,1,97,145,270,117,118,415
MissoulaCLINTON 92,61,84,3,21,7,3,132,173,373,166,145,546
MissoulaCOLD SPRINGS 89,177,259,10,28,29,8,242,636,734,317,436,1370
MissoulaCOLD SPRINGS 99,236,245,8,48,41,18,256,666,703,371,481,1369
MissoulaCSPORTER 98,180,359,13,24,18,4,229,839,613,288,539,1452
MissoulaEAST MSLA 92,70,208,0,11,6,1,112,421,316,130,278,737
MissoulaEVARO 94,68,87,6,6,2,1,79,235,189,94,155,424
MissoulaFRANKLIN 100N,144,454,0,15,5,5,74,900,271,99,598,1171
MissoulaFRANKLIN 100S,87,262,4,13,3,6,54,482,229,80,349,711
MissoulaFRENCHTWN 14N,12,28,0,16,3,1,43,58,142,63,40,200
MissoulaFRENCHTWN 14S,21,45,6,12,4,3,58,72,129,83,66,201
MissoulaFRENCHTWN 94,107,159,5,39,16,11,314,350,814,385,266,1164
MissoulaFRENCHTWN 96,38,64,2,28,9,0,131,128,382,170,102,510
MissoulaHAWTHORNE 95,139,321,3,24,10,3,129,707,405,169,460,1112
MissoulaHAWTHORNE 98N,60,114,3,10,10,2,78,296,213,103,174,509
MissoulaHAWTHORNE 98S,196,325,3,12,13,11,209,701,587,248,521,1288
MissoulaHELLGATE 94,273,301,8,31,41,12,249,790,624,341,574,1414
MissoulaHELLGATE 95,79,154,0,14,9,2,69,356,265,94,233,621
MissoulaHELLGATE 96E,467,600,15,82,40,36,552,1725,1765,725,1067,3490
MissoulaHELLGATE 96W,101,88,1,10,15,5,174,258,460,205,189,718
MissoulaHELLGATE 97,137,183,3,26,14,9,219,434,519,271,320,953
MissoulaLEWIS CLK 89,50,64,1,0,7,1,23,134,88,32,114,222
MissoulaLEWIS CLK 90E,245,290,2,12,15,17,171,853,421,217,535,1274
MissoulaLEWIS CLK 90W,430,553,11,28,31,13,212,1361,594,295,983,1955
MissoulaLIBRARY 91,263,745,5,8,2,1,74,1391,289,90,1008,1680
MissoulaLOLO 89,54,91,0,18,10,6,136,207,368,170,145,575
MissoulaLOLO 97,288,439,16,97,38,41,591,998,1637,783,727,2635
MissoulaLOWELL 94,180,482,2,5,1,2,53,899,223,63,662,1122
MissoulaLOWELL 95,207,669,3,10,5,3,101,1295,348,122,876,1643
MissoulaMEADOW HILL 99,253,384,6,25,30,14,212,900,652,287,637,1552
MissoulaPAXSON 89,326,469,4,5,11,14,55,1107,231,89,795,1338
MissoulaPETTY CRK 97,27,61,0,14,3,1,76,106,230,94,88,336
MissoulaPOTOMAC 92,47,116,4,23,13,7,167,229,439,214,163,668
MissoulaRATTLSNK 91E,325,399,5,13,28,14,121,984,330,181,724,1314
MissoulaRATTLSNK 91W,492,567,8,17,29,7,134,1414,351,195,1059,1765
MissoulaRUSSELL 90,74,139,6,8,6,2,37,307,149,59,213,456
MissoulaRUSSELL 99N,123,237,2,8,8,7,100,518,311,125,360,829
MissoulaRUSSELL 99S,202,292,12,28,17,13,174,710,494,244,494,1204
MissoulaSEELEY LK 92,137,172,8,31,25,13,338,337,758,415,309,1095
MissoulaSENIOR CIT 91,164,367,1,7,5,5,24,893,118,42,531,1011
MissoulaSENIOR CIT 95,94,321,0,5,3,2,24,561,121,34,415,682
MissoulaSPRING MDW 94,42,78,1,22,4,5,132,165,435,164,120,600
MissoulaSPRING MDW 96,16,31,0,7,2,2,52,67,145,63,47,212
MissoulaST JOSEPH 100E,336,547,5,11,10,4,79,1293,237,109,883,1530
MissoulaST JOSEPH 100W,305,810,4,14,12,6,91,1511,333,127,1115,1844
MissoulaSWAN 92,45,38,5,12,9,5,90,88,236,121,83,324
MissoulaTARGET RNG 97,152,179,3,23,21,7,194,459,490,248,331,949
MissoulaTARGET RNG 98,291,326,12,42,34,20,302,718,799,410,617,1517
MissoulaUC CENTR 89,6,92,0,3,0,2,3,422,154,8,98,576
MusselshellPRECINCT 1,32,23,5,22,10,4,167,83,328,208,55,411
MusselshellPRECINCT 3,19,16,3,13,9,6,162,50,296,193,35,346
MusselshellPRECINCT 5,10,24,5,31,5,9,285,70,507,335,34,577
MusselshellPRECINCT 6,25,45,6,40,15,8,323,111,643,392,70,754
MusselshellPRECINCT 7,4,6,1,5,2,0,60,10,114,68,10,124
MusselshellPRECINCT 8,2,2,0,12,3,1,43,8,79,59,4,87
Park59A NORTH PC,66,62,13,33,31,11,245,186,607,333,128,793
Park59B N CENTRAL PC,116,149,4,39,21,10,319,393,751,393,265,1144
Park59C S CENTRAL PC,65,134,3,20,15,11,274,286,620,323,199,906
Park59D SOUTH PC,106,116,9,23,12,7,154,402,392,205,222,794
Park60A NW OF LIVINGSTON,65,108,2,23,12,6,187,245,443,230,173,688
Park60B SW OF LIVINGSTON,70,80,2,17,15,4,163,229,464,201,150,693
Park60CL NW COL,77,137,9,26,16,8,182,317,525,241,214,842
Park60DL NE COL,85,171,2,13,5,5,119,322,345,144,256,667
Park60EL SE COL,81,204,2,11,4,8,93,411,230,118,285,641
Park60FL SC COL,89,175,0,11,13,2,79,360,251,105,264,611
Park60GL SW COL,96,185,3,18,14,9,130,444,352,174,281,796
PetroleumPRECNCT 1,16,16,3,9,9,6,167,30,278,194,32,308
PhillipsPCT 11 - FIRST CREEK - 32/16,4,4,0,4,1,0,18,8,32,23,8,40
PhillipsPCT 12-N - MALTA NORTH - 33/17,5,3,0,5,2,0,95,16,131,102,8,147
PhillipsPCT 12-S - MALTA SOUTH - 32/16,7,11,0,19,8,4,216,27,338,247,18,365
PhillipsPCT 16 - WHITEWATER - 33/17,2,0,0,4,0,0,49,6,72,53,2,78
PhillipsPCT 2-N - DODSON NORTH - 33/17,6,9,0,8,2,0,21,20,39,31,15,59
PhillipsPCT 2-S - DODSON SOUTH - 32/16,5,7,1,1,0,0,20,19,31,22,12,50
PhillipsPCT 5 - ZORTMAN - 32/16,2,3,0,3,3,1,36,16,50,43,5,66
PhillipsPCT 6 - LANDUSKY - 32/16,0,0,1,0,3,1,25,1,34,30,0,35
PhillipsPCT 7 - LORING - 33/17,0,3,0,2,0,0,38,6,59,40,3,65
PhillipsPCT 8-N - SACO NORTH - 33/17,6,7,1,6,6,2,112,32,184,127,13,216
PhillipsPCT 8-S - SACO SOUTH - 32/16,0,0,0,0,1,0,3,0,10,4,0,10
PhillipsPCT 9-1 - MALTA CITY - 33/17,20,15,11,20,18,9,227,78,378,285,35,456
PhillipsPCT 9-2 - MALTA CITY - 33/17,24,29,8,12,28,8,240,89,365,296,53,454
PonderaBRADY_19,30,22,4,7,9,4,131,75,225,155,52,300
PonderaCONRAD RURAL 29,9,4,2,4,8,3,67,24,127,84,13,151
PonderaCONRAD_24,50,36,9,30,24,9,193,135,393,265,86,528
PonderaCONRAD_27,46,34,2,19,13,17,198,125,409,249,80,534
PonderaDUPUYER_23,3,21,1,10,4,0,43,14,91,58,24,105
PonderaHEART BUTTE_20,77,69,0,4,0,1,7,241,19,12,146,260
PonderaVALIER (RURAL)_35,33,26,8,19,18,4,183,81,329,232,59,410
PonderaVALIER_34,9,25,6,8,1,5,109,43,206,129,34,249
Powder RiverPRECINCT03,0,2,1,5,1,1,17,9,35,25,2,44
Powder RiverPRECINCT04,0,0,0,0,4,0,19,3,40,23,0,43
Powder RiverPRECINCT05,6,11,1,2,4,1,61,20,105,69,17,125
Powder RiverPRECINCT08,1,0,0,0,1,1,16,2,21,18,1,23
Powder RiverPRECINCT09,1,0,1,2,0,1,30,15,43,34,1,58
Powder RiverPRECINCT11,11,12,3,21,16,5,208,51,349,253,23,400
Powder RiverPRECINCT12,5,9,8,18,15,4,165,27,291,210,14,318
PowellPRECINCT #1.80,8,3,2,14,5,1,75,11,146,97,11,157
PowellPRECINCT #10.80,6,1,0,5,0,0,31,9,70,36,7,79
PowellPRECINCT #11.80,2,8,1,4,0,1,42,7,93,48,10,100
PowellPRECINCT #12.80,4,13,0,6,2,0,52,20,116,60,17,136
PowellPRECINCT #14.80,9,16,0,8,5,4,64,31,121,81,25,152
PowellPRECINCT #16.78,17,12,0,4,1,0,34,34,89,39,29,123
PowellPRECINCT #2.80,8,8,0,8,3,0,25,18,73,36,16,91
PowellPRECINCT #3.78,22,38,6,8,5,3,113,68,279,135,60,347
PowellPRECINCT #4.78,22,23,3,8,2,3,67,61,197,83,45,258
PowellPRECINCT #5.78,33,35,2,8,12,7,88,97,215,117,68,312
PowellPRECINCT #6.78,40,34,2,10,8,8,82,73,241,110,74,314
PowellPRECINCT #7.78,16,38,2,11,3,3,79,76,234,98,54,310
PowellPRECINCT #8.80,18,22,0,10,5,7,69,46,155,91,40,201
PrairiePRECINCT NO. 1,15,16,2,6,5,6,56,41,125,75,31,166
PrairiePRECINCT NO. 2,20,10,5,10,1,3,57,26,118,76,30,144
PrairiePRECINCT NO. 3,7,8,1,3,1,2,65,19,134,72,15,153
PrairiePRECINCT NO. 4,6,10,3,17,5,4,92,14,179,121,16,193
RavalliPCT 01,32,41,1,20,11,1,227,122,461,260,73,583
RavalliPCT 02,71,74,5,56,26,14,364,211,754,465,145,965
RavalliPCT 03,37,51,4,35,19,9,201,129,506,268,88,635
RavalliPCT 04,59,53,5,32,37,18,233,187,514,325,112,701
RavalliPCT 05,112,137,16,54,32,17,375,369,782,494,249,1151
RavalliPCT 06,86,85,4,42,21,14,246,254,636,327,171,890
RavalliPCT 07,120,138,14,61,48,12,308,369,758,443,258,1127
RavalliPCT 08,136,162,14,45,28,19,224,492,575,330,298,1067
RavalliPCT 09,106,118,11,28,21,18,195,370,510,273,224,880
RavalliPCT 10,69,108,10,51,40,16,347,284,745,464,177,1029
RavalliPCT 11,59,77,9,49,53,19,340,248,744,470,136,992
RavalliPCT 12,63,81,11,39,36,10,256,232,565,352,144,797
RavalliPCT 13,44,54,5,54,26,11,245,166,610,341,98,776
RavalliPCT 14,0,2,3,73,6,7,57,3,213,146,2,216
RavalliPCT 15,91,101,4,51,32,14,391,299,771,492,192,1070
RavalliPCT 16,55,63,4,31,15,6,234,172,566,290,118,738
RavalliPCT 17,78,94,4,50,19,11,261,260,561,345,172,821
RavalliPCT 18,77,111,9,58,26,7,286,262,680,386,188,942
RavalliPCT 19,95,102,6,51,20,13,297,294,710,387,197,1004
RavalliPCT 20,90,90,6,43,27,8,203,283,525,287,180,808
RavalliPCT 21,46,57,2,33,14,6,139,137,361,194,103,498
RavalliPCT 22,131,112,6,55,26,17,300,364,755,404,243,1119
RavalliPCT 23,95,102,1,64,30,8,300,324,798,403,197,1122
RavalliPCT 24,114,156,6,60,25,9,285,392,710,385,270,1102
RichlandPRECINCT 01,9,9,1,12,7,2,48,35,165,70,18,200
RichlandPRECINCT 02,20,18,3,11,7,3,92,57,286,116,38,343
RichlandPRECINCT 03,19,22,5,12,8,7,117,73,311,149,41,384
RichlandPRECINCT 04,12,4,5,6,4,7,87,36,247,109,16,283
RichlandPRECINCT 05,21,11,1,20,7,1,97,48,278,126,32,326
RichlandPRECINCT 07,25,11,0,9,4,1,65,40,158,79,36,198
RichlandPRECINCT 08,31,16,5,25,18,18,188,87,466,254,47,553
RichlandPRECINCT 09,15,9,0,11,10,0,90,35,211,111,24,246
RichlandPRECINCT 12,15,24,1,4,4,5,161,73,479,175,39,552
RichlandPRECINCT 17,2,4,0,3,5,4,56,13,111,68,6,124
RichlandPRECINCT 19,6,8,3,3,5,1,53,14,101,65,14,115
RichlandPRECINCT 22,24,5,5,12,7,5,162,62,465,191,29,527
RichlandPRECINCT 23,19,17,0,25,23,13,222,98,630,283,36,728
Roosevelt02 BAINVILLE,16,12,0,8,2,0,63,33,195,73,28,228
Roosevelt10 FROID,11,18,1,1,1,4,69,38,139,76,29,177
Roosevelt12 CULBERTSON,38,20,4,4,11,3,159,91,387,181,58,478
Roosevelt15 BROCKTON,35,30,0,1,0,0,2,138,14,3,65,152
Roosevelt16 EAST POPLAR RURAL,23,32,0,0,1,0,13,163,52,14,55,215
Roosevelt17 NORTH POPLAR MINERAL BENCH,5,16,1,2,1,1,39,21,80,44,21,101
Roosevelt18 POPLAR,67,79,3,9,2,1,56,393,185,71,146,578
Roosevelt22 EAST & NE WOLF POINT RURAL,15,19,2,5,3,3,47,57,116,60,34,173
Roosevelt24 WOLF POINT SOUTHSIDE,37,47,0,3,1,2,35,183,135,41,84,318
Roosevelt26 WOLF POINT NORTHSIDE,42,73,2,12,2,4,147,167,287,167,115,454
Roosevelt27 WEST WOLF POINT RURAL,19,44,1,5,1,1,30,262,100,38,63,362
Roosevelt28 NORTH WOLF POINT RURAL (VICTORY),9,9,0,16,1,2,53,14,107,72,18,121
RosebudPRECINCT 10,5,14,1,2,1,1,64,11,126,69,19,137
RosebudPRECINCT 11,0,5,0,9,1,0,36,3,88,46,5,91
RosebudPRECINCT 15,55,73,0,0,1,1,14,400,61,16,128,461
RosebudPRECINCT 17,29,45,2,10,0,1,29,150,103,42,74,253
RosebudPRECINCT 20,10,16,1,6,6,3,109,29,170,125,26,199
RosebudPRECINCT 21,4,11,0,0,4,2,48,10,116,54,15,126
RosebudPRECINCT 26,0,5,1,2,0,0,23,4,60,26,5,64
RosebudPRECINCT 3,58,39,4,12,12,7,133,100,333,168,97,433
RosebudPRECINCT 30,16,34,1,11,1,3,92,59,274,108,50,333
RosebudPRECINCT 32,45,79,4,30,9,11,272,138,592,326,124,730
RosebudPRECINCT 6,27,34,1,7,6,2,126,70,300,142,61,370
RosebudPRECINCT 7,1,8,0,1,0,0,17,13,30,18,9,43
Sanders1-HERON-HD13,13,40,3,4,2,0,105,61,224,114,53,285
Sanders2-NOXON-HD13,36,40,2,14,8,2,146,88,332,172,76,420
Sanders3-TROUT CREEK-HD13,50,87,3,26,31,11,295,147,653,366,137,800
Sanders4-T Falls-HD13,77,88,8,31,17,7,318,194,682,381,165,876
Sanders5-T FALLS-HD13,78,78,5,27,26,14,347,196,707,419,156,903
Sanders6-PLAINS-HD14,47,62,3,54,22,15,352,152,740,446,109,892
Sanders7-PLAINS-HD14,46,52,12,40,16,8,253,132,494,329,98,626
Sanders8-HOT SPRINGS-HD14,41,119,7,11,11,0,139,180,378,168,160,558
Sanders9-Dixon-HD14,17,27,1,5,7,5,39,68,76,57,44,144
Sheridan1 WESTBY,8,11,2,5,3,2,44,35,126,56,19,161
Sheridan2 MEDICINE LAKE,40,42,4,5,8,5,112,107,244,134,82,351
Sheridan3 PLENTYWOOD WEST,47,28,4,7,10,6,87,103,237,114,75,340
Sheridan4 PLENTYWOOD EAST,42,42,1,11,14,6,129,131,337,161,84,468
Sheridan5 PLENTYWOOD RURAL WEST,11,10,2,4,7,0,74,34,163,87,21,197
Sheridan6 PLENTYWOOD RURAL EAST,23,21,7,5,5,2,54,67,134,73,44,201
Silver BowPREC_1,43,53,0,4,0,1,39,104,86,44,96,190
Silver BowPREC_10N,35,33,0,1,1,2,16,63,37,20,68,100
Silver BowPREC_10S,52,54,0,1,0,1,25,106,52,27,106,158
Silver BowPREC_11,46,49,1,1,2,2,18,97,64,24,95,161
Silver BowPREC_12E,61,49,1,10,4,0,41,113,100,56,110,213
Silver BowPREC_12W,50,37,0,2,1,0,20,98,54,23,87,152
Silver BowPREC_14,260,277,3,17,8,10,70,639,307,108,537,946
Silver BowPREC_16,246,250,3,18,19,6,155,631,363,201,496,994
Silver BowPREC_17,163,223,2,11,6,7,90,464,308,116,386,772
Silver BowPREC_18,123,135,0,10,1,1,73,312,230,85,258,542
Silver BowPREC_19N,87,66,1,2,5,3,55,173,101,66,153,274
Silver BowPREC_19S,62,30,0,6,6,1,33,113,83,46,92,196
Silver BowPREC_19W,16,21,0,2,5,0,26,46,45,33,37,91
Silver BowPREC_21,153,108,3,3,3,3,60,319,157,72,261,476
Silver BowPREC_22,291,291,10,26,15,6,194,622,520,251,582,1142
Silver BowPREC_26E,23,24,0,3,0,1,46,43,71,50,47,114
Silver BowPREC_26W,26,19,0,3,5,3,40,57,107,51,45,164
Silver BowPREC_27N,16,9,0,1,1,0,25,22,71,27,25,93
Silver BowPREC_27S,65,47,3,9,3,2,75,129,177,92,112,306
Silver BowPREC_28,14,12,0,8,3,0,35,33,78,46,26,111
Silver BowPREC_29,4,6,0,2,2,1,22,16,53,27,10,69
Silver BowPREC_2E,121,106,2,9,3,3,69,256,185,86,227,441
Silver BowPREC_2W,134,135,2,2,3,3,86,290,207,96,269,497
Silver BowPREC_3,114,91,1,7,2,4,51,235,154,65,205,389
Silver BowPREC_4,295,219,5,23,8,13,176,570,356,225,514,926
Silver BowPREC_6,471,374,14,29,28,22,222,938,562,315,845,1500
Silver BowPREC_8E,513,307,11,37,32,26,329,946,635,435,820,1581
Silver BowPREC_8W,287,249,3,16,10,7,226,575,545,262,536,1120
Silver BowPREC_9E,107,102,6,18,17,6,157,239,281,204,209,520
Silver BowPREC_9N,198,136,7,21,15,6,188,332,370,237,334,702
Silver BowPREC_9W,27,11,0,4,1,0,11,38,17,16,38,55
StillwaterABSAROKEE PRECINCT 13,56,61,2,39,33,16,290,187,615,380,117,802
StillwaterCOLUMBUS PRECINCT 1,100,109,16,89,50,31,743,363,1649,929,209,2012
StillwaterFISHTAIL PRECINCT 11,15,14,1,13,5,2,50,46,133,71,29,179
StillwaterMOLT PRECINCT 7,0,5,0,4,2,1,26,6,62,33,5,68
StillwaterNYE PRECINCT 10,15,16,0,5,4,2,43,46,86,54,31,132
StillwaterPARK CITY PRECINCT 2,86,86,8,44,21,11,362,212,831,446,172,1043
StillwaterRAPELJE PRECINCT 9,4,9,2,9,6,3,81,17,139,101,13,156
StillwaterREED POINT PRECINCT 4,15,7,6,12,4,2,67,31,146,91,22,177
Sweet GrassPRECINCT 1,18,33,0,16,7,6,140,85,343,169,51,428
Sweet GrassPRECINCT 2,27,29,1,27,23,5,119,108,281,175,56,389
Sweet GrassPRECINCT 3,16,32,3,17,20,10,178,82,370,228,48,452
Sweet GrassPRECINCT 4,35,33,7,22,12,8,155,96,364,204,68,460
Sweet GrassPRECINCT 5,11,5,1,11,6,3,116,31,237,137,16,268
TetonPRECINCT #1,177,255,10,35,25,13,364,384,928,447,432,1312
TetonPRECINCT #11,12,32,2,6,5,4,37,27,113,54,44,140
TetonPRECINCT #17,50,28,4,8,7,0,107,100,213,126,78,313
TetonPRECINCT #6,29,49,1,7,2,0,97,79,210,107,78,289
TetonPRECINCT #7,106,96,8,49,34,11,280,218,706,382,202,924
TooleDEVON-GALATA,13,6,1,6,7,6,63,25,101,83,19,126
TooleKEVIN,9,5,1,5,2,1,62,21,101,71,14,122
TooleSHELBY CITY,72,57,30,44,53,28,484,258,838,639,129,1096
TooleSHELBY RURAL,10,11,1,13,4,5,90,24,142,113,21,166
TooleSUNBURST,25,28,3,12,14,14,173,74,315,216,53,389
TreasurePRECINCT # 3,1,2,0,0,1,0,4,3,33,5,3,36
TreasurePRECINCT # 4,30,35,5,14,6,8,122,55,276,155,65,331
TreasurePRECINCT # 6,3,6,0,1,0,0,18,1,42,19,9,43
Valley1-FORT PECK,63,79,1,18,9,4,196,158,393,228,142,551
Valley2-FRAZER,20,20,0,3,1,1,43,94,75,48,40,169
Valley3-HINSDALE,11,15,4,21,10,7,157,33,269,199,26,302
Valley4-GLASGOW,119,100,16,45,39,28,325,319,800,453,219,1119
Valley5-GLASGOW NE,95,80,13,43,25,10,338,219,742,429,175,961
Valley6-NASHUA,23,28,3,8,0,2,73,41,174,86,51,215
Valley7-LUSTRE,3,1,3,10,4,3,47,3,94,67,4,97
Valley8-OPHEIM,10,15,2,13,8,3,72,19,151,98,25,170
WheatlandPRECINCT 1,1,3,2,1,1,2,33,5,61,39,4,66
WheatlandPRECINCT 2,23,23,5,20,14,2,153,92,290,194,46,382
WheatlandPRECINCT 3,5,2,1,5,2,1,40,17,69,49,7,86
WheatlandPRECINCT 4,9,10,0,3,2,2,63,27,102,70,19,129
WheatlandPRECINCT 9,10,14,4,7,8,8,92,38,180,119,24,218
WibauxPRECINCT #1,36,16,3,26,21,4,231,55,463,285,52,518
Yellowstone39.1,10,6,2,15,4,1,72,21,151,94,16,172
Yellowstone39.2,134,137,19,71,25,12,566,296,1242,693,271,1538
Yellowstone40-45,74,55,5,43,15,11,297,188,626,371,129,814
Yellowstone40.1,111,138,17,86,20,8,623,297,1319,754,249,1616
Yellowstone40.3,20,28,4,15,5,4,122,49,266,150,48,315
Yellowstone40.4,15,19,0,19,7,4,85,60,195,115,34,255
Yellowstone40.5,13,10,0,15,1,3,51,28,150,70,23,178
Yellowstone42.1,9,7,0,4,2,2,38,17,86,46,16,103
Yellowstone42.2,14,16,0,7,5,1,65,59,169,78,30,228
Yellowstone43.1,34,12,4,19,17,1,184,86,399,225,46,485
Yellowstone43.2,88,83,7,33,14,14,270,165,530,338,171,695
Yellowstone43.3,299,267,16,128,70,29,826,927,1941,1069,566,2868
Yellowstone44.1,93,99,7,37,23,9,258,266,596,334,192,862
Yellowstone44.2,222,205,9,83,47,26,509,627,1145,674,427,1772
Yellowstone44.3,193,144,7,61,42,21,447,463,882,578,337,1345
Yellowstone45.2,386,330,45,162,129,61,1107,1181,2408,1504,716,3589
Yellowstone46.1,23,20,4,15,13,5,88,71,165,125,43,236
Yellowstone46.2,837,540,54,168,283,107,1531,1971,3017,2143,1377,4988
Yellowstone47.1,207,229,9,29,27,12,183,724,571,260,436,1295
Yellowstone47.2,430,338,26,68,148,38,583,1159,1165,863,768,2324
Yellowstone48.1,394,421,24,85,57,27,458,1159,1105,651,815,2264
Yellowstone48.2,335,245,27,79,83,31,479,866,1107,699,580,1973
Yellowstone49.1,222,243,3,36,43,12,191,726,584,285,465,1310
Yellowstone49.2,224,292,10,61,34,23,355,758,869,483,516,1627
Yellowstone50.1,240,276,11,61,27,15,303,702,850,417,516,1552
Yellowstone50.2,282,244,12,56,67,27,517,751,1101,679,526,1852
Yellowstone51.1,140,133,8,30,22,6,260,425,652,326,273,1077
Yellowstone51.2,109,97,4,40,30,8,180,363,491,262,206,854
Yellowstone51.3,202,208,8,67,33,28,401,613,984,537,410,1597
Yellowstone52.1,202,216,9,46,26,8,321,608,830,410,418,1438
Yellowstone52.2,311,254,15,81,46,25,589,780,1214,756,565,1994
Yellowstone53.1,405,325,42,182,184,59,1392,1232,2978,1859,730,4210
Yellowstone53.2,84,107,5,78,32,17,460,258,1063,592,191,1321
Yellowstone53.3,112,96,12,34,24,16,388,221,792,474,208,1013
Yellowstone54.1,563,432,41,165,128,66,1286,1516,2806,1686,995,4322
Yellowstone54.2,69,81,6,56,26,15,296,200,616,399,150,816
Yellowstone55.1,37,33,5,12,8,5,133,118,385,163,70,503
Yellowstone55.2,5,1,0,4,3,1,32,13,67,40,6,80
Yellowstone55.3,102,82,9,60,24,21,310,234,743,424,184,977
Yellowstone55.4,131,134,6,33,12,9,250,344,731,310,265,1075
Yellowstone55.5,199,164,11,82,47,15,421,501,1027,576,363,1528
Yellowstone56.1,22,34,2,15,8,7,106,64,235,138,56,299
Yellowstone56.2,274,318,21,138,63,30,882,849,2144,1134,592,2993
Yellowstone56.3,82,65,10,31,29,10,261,215,523,341,147,738
