precinct,pri_dem_CLINTON,pri_dem_SANDERS,pri_rep_BUSH,pri_rep_CARSON,pri_rep_CRUZ,pri_rep_FIORINA,pri_rep_KASICH,pri_rep_TRUMP,gen_dem_CLINTON,gen_rep_TRUMP,rep_primary_total,dem_primary_total,general_total
Bernalillo1,60,93,3,6,15,0,9,64,346,311,97,153,657
Bernalillo10,65,65,1,5,9,2,7,35,287,223,59,130,510
Bernalillo101,35,186,2,1,3,0,2,10,341,57,18,221,398
Bernalillo102,27,105,0,0,2,1,1,6,231,35,10,132,266
Bernalillo103,91,96,1,1,5,0,1,15,490,125,23,187,615
Bernalillo104,20,25,0,0,0,0,0,1,115,14,1,45,129
Bernalillo105,33,23,0,0,1,0,0,1,151,30,2,56,181
Bernalillo106,116,71,2,2,3,0,6,11,396,91,24,187,487
Bernalillo107,89,101,3,1,6,1,3,11,336,61,25,190,397
Bernalillo108,50,36,5,1,1,1,7,30,161,131,45,86,292
Bernalillo109,9,7,0,0,0,0,0,2,25,16,2,16,41
Bernalillo11,179,145,5,2,7,1,12,52,495,201,79,324,696
Bernalillo110,87,82,6,2,16,1,6,46,337,249,77,169,586
Bernalillo111,132,129,5,2,18,1,6,68,521,377,100,261,898
Bernalillo112,141,130,1,7,24,4,10,112,513,469,158,271,982
Bernalillo113,77,91,4,3,5,5,10,66,309,288,93,168,597
Bernalillo114,196,161,12,14,28,6,31,164,675,750,255,357,1425
Bernalillo115,203,177,10,5,36,0,15,186,885,873,252,380,1758
Bernalillo116,66,69,1,3,10,1,3,63,238,278,81,135,516
Bernalillo117,175,152,4,6,49,6,14,156,698,777,235,327,1475
Bernalillo118,82,100,3,8,11,1,9,114,454,528,146,182,982
Bernalillo119,193,199,3,3,21,0,12,101,763,468,140,392,1231
Bernalillo12,120,120,1,0,10,1,7,44,394,184,63,240,578
Bernalillo120,167,132,1,3,11,0,5,69,586,359,89,299,945
Bernalillo121,191,129,5,1,7,1,9,34,488,141,57,320,629
Bernalillo122,65,108,2,0,0,0,3,6,217,44,11,173,261
Bernalillo123,80,171,1,2,4,0,2,12,383,65,21,251,448
Bernalillo124,47,105,0,1,1,1,3,1,251,37,7,152,288
Bernalillo125,84,128,0,0,4,1,1,11,307,68,17,212,375
Bernalillo127,121,141,6,1,13,1,9,102,598,602,132,262,1200
Bernalillo128,64,82,3,1,9,1,9,59,246,277,82,146,523
Bernalillo129,47,54,0,1,4,1,5,46,217,234,57,101,451
Bernalillo13,149,104,3,2,6,5,12,45,348,166,73,253,514
Bernalillo131,38,65,2,2,2,1,1,8,179,47,16,103,226
Bernalillo132,38,98,1,0,0,0,5,4,255,54,10,136,309
Bernalillo133,44,55,0,1,0,0,1,5,202,42,7,99,244
Bernalillo134,200,227,4,5,20,2,12,108,870,577,151,427,1447
Bernalillo135,79,90,0,0,3,0,1,9,295,56,13,169,351
Bernalillo136,114,103,2,3,13,0,3,35,487,231,56,217,718
Bernalillo137,43,74,2,6,10,2,1,12,293,154,33,117,447
Bernalillo138,95,74,1,0,5,0,4,33,443,168,43,169,611
Bernalillo139,79,44,0,0,3,1,1,16,220,114,21,123,334
Bernalillo14,71,93,1,4,5,0,5,42,317,186,57,164,503
Bernalillo140,52,63,0,1,4,0,0,21,305,131,26,115,436
Bernalillo141,73,66,2,1,11,1,0,35,346,159,50,139,505
Bernalillo142,104,102,1,3,8,0,4,37,490,243,53,206,733
Bernalillo143,40,40,3,0,3,0,1,8,226,81,15,80,307
Bernalillo144,77,61,1,0,5,0,1,34,317,202,41,138,519
Bernalillo15,85,74,2,3,6,2,11,53,340,246,77,159,586
Bernalillo150,243,156,3,2,4,5,26,45,596,189,85,399,785
Bernalillo151,136,138,2,2,3,2,1,21,409,118,31,274,527
Bernalillo152,117,116,3,1,4,1,6,17,337,105,32,233,442
Bernalillo153,108,118,1,2,7,2,2,24,334,131,38,226,465
Bernalillo154,212,169,4,1,5,2,6,28,681,205,46,381,886
Bernalillo16,58,78,0,4,5,1,3,34,246,148,47,136,394
Bernalillo161,42,47,0,2,3,1,2,10,214,69,18,89,283
Bernalillo162,115,152,3,3,1,4,3,14,445,92,28,267,537
Bernalillo163,56,64,1,3,4,1,0,13,212,46,22,120,258
Bernalillo164,53,97,0,0,2,0,3,14,247,69,19,150,316
Bernalillo165,77,120,2,0,4,1,1,17,291,40,25,197,331
Bernalillo166,59,117,2,0,6,0,3,8,234,39,19,176,273
Bernalillo17,137,148,2,7,11,3,4,48,422,246,75,285,668
Bernalillo170,101,130,3,4,11,0,6,88,506,429,112,231,935
Bernalillo171,110,105,3,1,15,1,10,86,498,381,116,215,879
Bernalillo18,126,104,4,1,8,0,6,36,415,217,55,230,632
Bernalillo180,66,58,0,1,4,1,7,26,190,77,39,124,267
Bernalillo181,213,156,0,3,5,2,8,37,591,164,55,369,755
Bernalillo182,80,64,2,1,12,2,3,12,238,112,32,144,350
Bernalillo183,159,178,2,3,9,1,4,42,479,184,61,337,663
Bernalillo184,104,86,4,4,3,0,6,23,291,95,40,190,386
Bernalillo185,222,176,5,0,14,1,12,42,626,201,74,398,827
Bernalillo186,144,130,3,1,11,1,3,21,485,171,40,274,656
Bernalillo187,145,108,1,1,4,0,3,28,416,118,37,253,534
Bernalillo19,135,135,6,12,25,3,19,132,565,604,197,270,1169
Bernalillo191,70,75,2,3,9,0,1,19,222,89,34,145,311
Bernalillo192,80,92,0,1,3,0,0,19,288,74,23,172,362
Bernalillo193,58,98,4,0,2,1,1,26,270,102,34,156,372
Bernalillo194,83,78,0,3,2,0,3,20,303,119,28,161,422
Bernalillo195,64,73,2,1,4,0,0,13,209,70,20,137,279
Bernalillo196,39,37,4,1,5,0,3,10,176,68,23,76,244
Bernalillo197,66,78,1,0,3,1,0,16,304,99,21,144,403
Bernalillo2,65,66,3,2,13,1,8,57,288,270,84,131,558
Bernalillo20,164,113,2,3,16,0,10,93,486,381,124,277,867
Bernalillo21,191,161,5,5,23,3,12,110,653,506,158,352,1159
Bernalillo211,38,35,1,1,2,0,0,8,173,40,12,73,213
Bernalillo212,76,62,0,0,0,1,0,9,267,46,10,138,313
Bernalillo214,49,109,3,0,2,0,1,7,280,45,13,158,325
Bernalillo215,29,92,0,1,1,0,2,4,218,39,8,121,257
Bernalillo216,81,71,1,0,3,0,5,16,279,76,25,152,355
Bernalillo217,17,14,0,0,0,0,0,4,60,17,4,31,77
Bernalillo22,81,86,3,5,12,3,11,80,317,278,114,167,595
Bernalillo221,90,149,1,0,1,2,0,11,427,80,15,239,507
Bernalillo223,27,95,0,0,1,0,1,1,208,19,3,122,227
Bernalillo224,33,63,0,0,0,0,1,6,176,32,7,96,208
Bernalillo225,23,33,0,2,0,0,0,2,91,17,4,56,108
Bernalillo226,42,44,0,0,2,0,0,1,163,22,3,86,185
Bernalillo23,140,114,1,5,18,1,8,66,453,353,99,254,806
Bernalillo24,175,182,2,3,25,1,12,102,653,498,145,357,1151
Bernalillo241,26,112,0,2,2,0,1,8,228,35,13,138,263
Bernalillo242,38,156,1,0,1,0,0,5,282,33,7,194,315
Bernalillo243,35,182,1,0,1,1,4,4,342,47,11,217,389
Bernalillo244,109,169,1,2,2,1,3,21,455,64,30,278,519
Bernalillo245,73,143,0,2,0,0,1,7,331,45,10,216,376
Bernalillo246,27,52,1,1,2,0,0,4,183,33,8,79,216
Bernalillo25,144,133,4,6,19,4,13,96,574,471,142,277,1045
Bernalillo251,74,98,1,0,0,0,1,12,280,49,14,172,329
Bernalillo252,101,83,2,0,2,1,5,15,321,54,25,184,375
Bernalillo253,115,156,1,1,5,0,2,27,490,115,36,271,605
Bernalillo254,115,157,0,2,3,1,12,16,442,101,34,272,543
Bernalillo255,107,172,2,0,3,1,2,19,443,98,27,279,541
Bernalillo256,95,140,2,0,2,1,3,11,351,62,19,235,413
Bernalillo257,0,0,0,0,0,0,0,0,0,0,0,0,0
Bernalillo258,7,18,1,0,5,0,3,38,99,174,47,25,273
Bernalillo26,163,149,2,3,5,3,4,88,551,327,105,312,878
Bernalillo27,83,87,3,1,6,0,2,31,361,157,43,170,518
Bernalillo271,75,154,1,0,7,1,4,15,336,93,28,229,429
Bernalillo272,88,116,0,0,2,1,5,15,341,54,23,204,395
Bernalillo273,112,114,2,4,5,1,3,27,409,116,42,226,525
Bernalillo274,73,109,1,1,4,2,2,15,298,47,25,182,345
Bernalillo275,68,106,1,1,8,0,1,28,390,171,39,174,561
Bernalillo278,43,50,2,0,7,2,0,32,169,116,43,93,285
Bernalillo28,56,67,0,0,8,1,3,17,258,129,29,123,387
Bernalillo281,54,74,1,3,1,0,0,6,212,58,11,128,270
Bernalillo282,84,90,2,0,6,2,5,23,332,140,38,174,472
Bernalillo283,32,50,0,0,2,1,0,12,151,51,15,82,202
Bernalillo284,62,71,3,1,5,2,6,14,230,113,31,133,343
Bernalillo285,43,50,1,2,9,0,2,16,193,87,30,93,280
Bernalillo286,72,86,3,2,10,2,0,30,385,164,47,158,549
Bernalillo287,39,58,2,0,2,0,1,10,198,77,15,97,275
Bernalillo289,214,161,17,18,42,4,45,244,848,899,370,375,1747
Bernalillo29,78,83,4,2,5,2,2,54,356,207,69,161,563
Bernalillo290,52,23,7,3,11,2,15,69,120,165,107,75,285
Bernalillo291,59,62,3,3,3,2,3,31,211,177,45,121,388
Bernalillo292,113,140,4,4,14,3,12,91,494,392,128,253,886
Bernalillo293,107,83,5,2,5,2,3,49,379,207,66,190,586
Bernalillo294,54,54,9,3,17,4,32,123,218,323,188,108,541
Bernalillo295,67,56,1,2,8,0,15,75,233,259,101,123,492
Bernalillo296,43,38,2,2,8,0,4,36,175,131,52,81,306
Bernalillo297,86,100,3,2,9,1,5,55,343,251,75,186,594
Bernalillo298,80,88,3,5,13,1,6,37,362,252,65,168,614
Bernalillo299,78,99,6,1,15,2,17,77,345,290,118,177,635
Bernalillo3,86,95,2,2,14,0,4,66,381,352,88,181,733
Bernalillo30,292,168,9,4,25,4,33,165,870,624,240,460,1494
Bernalillo300,40,40,3,0,8,2,3,24,164,143,40,80,307
Bernalillo301,71,51,4,2,14,3,7,41,246,226,71,122,472
Bernalillo302,178,150,7,9,33,1,40,173,613,619,263,328,1232
Bernalillo303,56,40,2,2,7,1,5,33,184,114,50,96,298
Bernalillo304,59,46,2,2,7,2,10,37,202,175,60,105,377
Bernalillo305,62,84,5,1,6,0,5,37,299,155,54,146,454
Bernalillo306,43,52,2,2,5,1,4,33,151,152,47,95,303
Bernalillo307,73,63,0,0,14,0,11,52,265,219,77,136,484
Bernalillo308,53,45,2,3,11,3,4,46,179,174,69,98,353
Bernalillo31,90,58,1,1,1,0,0,17,346,64,20,148,410
Bernalillo311,48,97,1,0,4,2,5,25,269,94,37,145,363
Bernalillo312,56,133,0,0,3,0,3,21,319,85,27,189,404
Bernalillo313,36,58,2,1,0,1,0,14,171,68,18,94,239
Bernalillo314,71,98,0,2,7,1,8,23,244,163,41,169,407
Bernalillo315,48,70,2,0,7,2,10,29,212,140,50,118,352
Bernalillo316,92,79,5,2,12,1,8,45,263,172,73,171,435
Bernalillo317,45,67,2,3,7,1,2,36,197,101,51,112,298
Bernalillo318,51,49,0,0,3,1,0,16,293,114,20,100,407
Bernalillo32,90,88,3,0,1,0,1,25,381,145,30,178,526
Bernalillo321,46,63,1,3,3,0,1,11,199,69,19,109,268
Bernalillo322,33,56,1,0,2,0,2,14,150,66,19,89,216
Bernalillo323,36,66,2,0,2,2,3,18,252,101,27,102,353
Bernalillo324,139,129,5,9,16,3,12,102,527,387,147,268,914
Bernalillo326,64,61,1,2,7,0,2,17,248,80,29,125,328
Bernalillo327,45,63,2,4,7,0,2,30,266,163,45,108,429
Bernalillo328,116,134,7,6,16,2,20,125,489,437,176,250,926
Bernalillo329,48,52,2,0,4,0,0,20,212,132,26,100,344
Bernalillo33,162,84,1,2,5,1,1,18,503,143,28,246,646
Bernalillo330,28,39,3,0,3,0,2,27,160,100,35,67,260
Bernalillo331,25,49,0,1,5,1,0,15,190,77,22,74,267
Bernalillo332,71,90,0,2,9,2,5,55,239,207,73,161,446
Bernalillo333,103,78,8,6,27,2,34,149,364,436,226,181,800
Bernalillo34,68,30,0,0,1,0,0,10,219,88,11,98,307
Bernalillo341,88,102,2,0,3,0,7,23,294,72,35,190,366
Bernalillo342,32,97,0,1,1,0,2,5,209,25,9,129,234
Bernalillo343,92,154,1,1,2,2,6,13,347,59,25,246,406
Bernalillo344,124,165,5,2,2,0,7,30,451,118,46,289,569
Bernalillo345,130,163,3,7,9,1,11,27,544,146,58,293,690
Bernalillo346,32,60,2,1,4,1,0,19,200,109,27,92,309
Bernalillo347,48,76,1,0,8,0,2,31,231,152,42,124,383
Bernalillo35,58,56,1,1,9,1,2,25,215,104,39,114,319
Bernalillo351,78,100,0,2,2,1,4,3,271,29,12,178,300
Bernalillo352,105,116,0,2,2,3,2,17,353,68,26,221,421
Bernalillo353,53,90,0,0,2,0,0,4,205,22,6,143,227
Bernalillo354,94,110,1,1,3,2,6,18,332,56,31,204,388
Bernalillo355,122,142,1,0,2,1,1,6,407,42,11,264,449
Bernalillo356,84,121,1,1,2,1,7,7,324,46,19,205,370
Bernalillo357,52,92,2,2,0,0,8,4,216,23,16,144,239
Bernalillo358,11,78,0,0,2,1,1,3,277,80,7,89,357
Bernalillo36,104,90,4,0,4,0,1,20,319,104,29,194,423
Bernalillo37,192,106,1,2,13,3,5,44,447,220,68,298,667
Bernalillo371,124,132,3,1,5,3,13,37,416,138,62,256,554
Bernalillo372,37,85,0,1,5,1,3,15,193,68,25,122,261
Bernalillo373,49,56,1,2,7,1,3,24,204,83,38,105,287
Bernalillo374,92,82,3,1,1,1,8,13,259,76,27,174,335
Bernalillo375,141,155,5,0,4,3,10,38,508,178,60,296,686
Bernalillo38,173,94,2,1,3,2,3,36,527,220,47,267,747
Bernalillo381,88,113,2,1,2,0,1,7,312,35,13,201,347
Bernalillo382,71,99,2,1,3,0,3,14,252,64,23,170,316
Bernalillo383,51,147,0,0,0,2,3,7,306,62,12,198,368
Bernalillo384,85,121,1,3,1,0,5,28,343,94,38,206,437
Bernalillo385,89,95,2,2,3,0,4,11,307,63,22,184,370
Bernalillo386,74,103,2,0,2,0,5,8,236,39,17,177,275
Bernalillo387,92,104,0,0,1,1,3,15,274,67,20,196,341
Bernalillo39,157,104,1,2,9,5,10,55,441,214,82,261,655
Bernalillo4,107,85,5,5,8,1,21,66,290,202,106,192,492
Bernalillo40,90,72,2,1,4,0,1,30,324,151,38,162,475
Bernalillo400,30,52,2,0,6,0,2,20,136,95,30,82,231
Bernalillo401,70,68,5,1,6,0,6,40,249,144,58,138,393
Bernalillo402,69,78,6,5,11,2,6,46,236,165,76,147,401
Bernalillo403,55,83,0,1,1,1,4,26,216,120,33,138,336
Bernalillo404,99,90,3,3,11,1,6,48,286,199,72,189,485
Bernalillo405,73,74,1,4,2,2,0,28,268,132,37,147,400
Bernalillo406,42,56,1,0,11,0,8,20,181,108,40,98,289
Bernalillo407,101,81,6,2,15,0,5,73,325,282,101,182,607
Bernalillo408,58,55,4,2,9,4,11,63,194,194,93,113,388
Bernalillo409,75,113,3,2,6,1,13,42,436,246,67,188,682
Bernalillo41,137,93,3,2,12,1,4,38,509,231,60,230,740
Bernalillo410,63,50,3,4,8,1,5,51,216,209,72,113,425
Bernalillo411,60,98,4,1,8,0,7,20,293,129,40,158,422
Bernalillo412,26,40,1,1,1,1,0,11,120,42,15,66,162
Bernalillo413,74,106,6,1,5,1,7,42,342,165,62,180,507
Bernalillo414,31,52,0,2,3,0,1,24,140,94,30,83,234
Bernalillo415,39,38,0,1,4,0,8,27,132,109,40,77,241
Bernalillo416,52,66,3,2,6,2,4,20,204,109,37,118,313
Bernalillo417,65,76,5,0,4,1,13,19,260,126,42,141,386
Bernalillo418,45,42,1,2,3,0,6,36,209,175,48,87,384
Bernalillo419,148,110,3,3,24,4,15,115,370,343,164,258,713
Bernalillo42,85,71,2,1,7,0,0,14,273,123,24,156,396
Bernalillo420,101,105,1,0,11,2,5,65,384,284,84,206,668
Bernalillo421,60,90,2,8,6,2,11,62,277,253,91,150,530
Bernalillo422,148,142,5,3,22,5,12,137,602,630,184,290,1232
Bernalillo423,161,129,7,10,14,6,27,181,676,734,245,290,1410
Bernalillo424,157,130,4,4,25,8,28,184,698,822,253,287,1520
Bernalillo425,141,90,7,5,14,3,26,128,524,547,183,231,1071
Bernalillo426,99,89,7,4,15,3,28,99,376,367,156,188,743
Bernalillo427,210,129,15,9,39,4,36,135,671,698,238,339,1369
Bernalillo428,84,56,1,1,5,1,9,76,314,242,93,140,556
Bernalillo429,128,77,10,3,14,1,30,91,446,369,149,205,815
Bernalillo43,76,60,2,2,2,0,5,34,389,167,45,136,556
Bernalillo430,53,58,6,3,13,0,10,65,253,269,97,111,522
Bernalillo431,52,71,2,2,4,0,7,28,215,119,43,123,334
Bernalillo432,72,102,1,1,3,2,6,36,317,185,49,174,502
Bernalillo433,55,48,2,0,5,0,3,27,195,121,37,103,316
Bernalillo434,44,46,1,2,6,0,6,14,168,74,29,90,242
Bernalillo435,63,88,5,0,10,1,1,47,303,201,64,151,504
Bernalillo436,69,50,1,3,4,0,3,30,204,127,41,119,331
Bernalillo437,37,49,3,0,7,1,2,17,140,65,30,86,205
Bernalillo438,49,75,2,0,5,2,3,18,345,137,30,124,482
Bernalillo439,84,111,3,4,9,3,8,34,389,187,61,195,576
Bernalillo44,130,148,1,0,8,1,5,40,511,233,55,278,744
Bernalillo440,39,36,2,1,4,2,6,17,139,99,32,75,238
Bernalillo441,68,63,1,1,2,2,2,20,222,110,28,131,332
Bernalillo442,51,89,1,0,5,2,2,17,253,110,27,140,363
Bernalillo443,47,76,1,2,5,2,1,19,191,96,30,123,287
Bernalillo444,43,78,1,1,2,0,4,23,209,105,31,121,314
Bernalillo445,50,59,0,2,4,0,5,34,178,134,45,109,312
Bernalillo446,58,59,3,1,4,4,7,26,210,144,45,117,354
Bernalillo447,156,107,9,6,38,4,30,224,621,975,311,263,1596
Bernalillo448,126,91,7,11,22,2,14,86,483,406,142,217,889
Bernalillo449,81,109,5,3,7,1,7,48,421,236,71,190,657
Bernalillo45,92,48,1,0,5,1,0,25,228,119,32,140,347
Bernalillo450,44,45,7,2,10,2,9,60,188,191,90,89,379
Bernalillo451,40,48,2,1,3,1,4,26,227,135,37,88,362
Bernalillo452,48,65,1,1,5,0,5,44,196,155,56,113,351
Bernalillo453,98,140,3,4,7,1,6,47,493,301,68,238,794
Bernalillo454,82,78,5,3,22,1,6,98,331,321,135,160,652
Bernalillo455,274,213,6,8,32,1,16,168,938,773,231,487,1711
Bernalillo456,93,103,6,7,16,6,9,83,416,420,127,196,836
Bernalillo46,152,111,2,0,4,0,2,23,411,177,31,263,588
Bernalillo461,38,48,2,2,4,0,9,37,174,132,54,86,306
Bernalillo462,47,43,1,4,2,1,5,28,172,113,41,90,285
Bernalillo463,33,50,2,3,6,0,3,36,167,153,50,83,320
Bernalillo464,27,59,0,1,4,2,1,27,136,108,35,86,244
Bernalillo465,82,100,1,2,10,0,6,61,358,226,80,182,584
Bernalillo466,49,62,2,5,7,1,2,39,202,206,56,111,408
Bernalillo47,53,40,0,1,1,0,2,8,151,70,12,93,221
Bernalillo471,52,75,4,3,4,0,16,58,186,165,85,127,351
Bernalillo472,39,42,3,2,7,1,5,35,135,157,53,81,292
Bernalillo473,58,45,2,1,10,0,4,33,182,101,50,103,283
Bernalillo474,39,28,0,3,4,0,3,24,130,114,34,67,244
Bernalillo475,52,85,3,2,9,1,4,36,267,167,55,137,434
Bernalillo476,69,81,1,2,13,3,7,56,228,249,82,150,477
Bernalillo477,104,81,0,4,9,3,3,33,381,165,52,185,546
Bernalillo478,85,78,5,3,9,1,3,31,310,178,52,163,488
Bernalillo48,118,113,3,0,11,0,2,26,434,156,42,231,590
Bernalillo480,73,93,4,2,15,2,7,80,301,289,110,166,590
Bernalillo481,26,33,1,1,2,1,5,17,151,87,27,59,238
Bernalillo482,74,58,9,1,10,3,27,88,253,300,138,132,553
Bernalillo483,77,73,3,9,13,1,10,65,335,336,101,150,671
Bernalillo484,70,60,3,2,9,1,10,41,255,166,66,130,421
Bernalillo485,83,53,3,3,17,4,13,71,282,279,111,136,561
Bernalillo486,90,85,4,1,24,2,13,81,329,305,125,175,634
Bernalillo487,91,50,3,3,6,1,6,52,270,241,71,141,511
Bernalillo488,93,63,6,1,15,3,14,88,267,261,127,156,528
Bernalillo489,94,62,1,3,21,2,8,64,313,305,99,156,618
Bernalillo49,101,92,3,2,9,0,0,19,603,160,33,193,763
Bernalillo490,61,49,6,2,14,4,9,71,213,307,106,110,520
Bernalillo491,40,60,4,1,5,2,6,32,164,141,50,100,305
Bernalillo492,45,55,5,6,7,1,4,37,154,136,60,100,290
Bernalillo493,53,72,2,4,6,1,8,42,215,204,63,125,419
Bernalillo494,46,58,4,1,16,0,15,34,188,156,70,104,344
Bernalillo495,66,85,7,4,11,0,14,42,290,227,78,151,517
Bernalillo496,46,60,8,1,14,3,10,40,164,174,76,106,338
Bernalillo497,66,79,4,4,7,0,12,35,236,179,62,145,415
Bernalillo498,78,84,3,3,9,0,12,37,316,196,64,162,512
Bernalillo499,69,51,0,5,5,0,8,53,245,209,71,120,454
Bernalillo5,95,94,4,1,3,0,7,33,302,183,48,189,485
Bernalillo50,149,159,3,1,12,0,5,59,686,289,80,308,975
Bernalillo500,83,72,2,4,17,6,20,83,291,305,132,155,596
Bernalillo502,78,98,3,4,6,2,3,36,282,198,54,176,480
Bernalillo503,30,67,1,5,3,2,2,19,177,127,32,97,304
Bernalillo504,37,52,2,6,6,1,4,25,175,117,44,89,292
Bernalillo505,41,55,4,3,14,1,3,37,184,159,62,96,343
Bernalillo506,36,59,1,2,6,2,6,36,172,134,53,95,306
Bernalillo507,44,44,3,6,12,0,13,37,172,175,71,88,347
Bernalillo508,36,50,2,4,5,0,3,31,158,144,45,86,302
Bernalillo509,38,42,1,3,2,1,0,26,123,91,33,80,214
Bernalillo51,105,51,3,1,3,1,1,14,364,85,23,156,449
Bernalillo510,78,79,2,2,16,0,5,49,294,258,74,157,552
Bernalillo511,66,62,1,2,14,2,5,61,232,259,85,128,491
Bernalillo512,79,60,4,9,11,3,14,63,310,267,104,139,577
Bernalillo513,90,92,7,4,19,3,23,90,368,352,146,182,720
Bernalillo514,68,78,3,4,14,1,5,49,269,268,76,146,537
Bernalillo515,47,44,3,2,11,2,13,46,195,215,77,91,410
Bernalillo516,67,109,5,5,18,2,18,63,350,296,111,176,646
Bernalillo517,29,48,4,6,10,2,16,55,173,223,93,77,396
Bernalillo518,53,76,6,5,16,3,13,65,279,292,108,129,571
Bernalillo519,26,33,2,3,4,1,2,27,125,137,39,59,262
Bernalillo52,165,185,2,2,13,1,3,54,732,335,75,350,1067
Bernalillo520,111,92,4,5,9,2,25,85,402,372,130,203,774
Bernalillo521,57,86,3,5,13,3,11,68,279,260,103,143,539
Bernalillo522,95,106,4,4,16,6,20,113,416,398,163,201,814
Bernalillo523,76,88,4,5,9,2,18,52,233,223,90,164,456
Bernalillo524,25,37,4,3,5,2,8,46,112,127,68,62,239
Bernalillo525,51,75,1,4,13,1,6,46,282,222,71,126,504
Bernalillo526,71,79,3,3,9,2,16,88,294,312,121,150,606
Bernalillo527,21,23,4,0,9,1,8,36,82,135,58,44,217
Bernalillo528,34,26,3,2,5,0,9,41,105,146,60,60,251
Bernalillo529,91,92,2,7,23,3,11,96,414,374,142,183,788
Bernalillo53,67,55,0,2,6,0,2,12,256,105,22,122,361
Bernalillo530,78,107,11,2,10,2,14,62,363,274,101,185,637
Bernalillo531,48,58,1,2,1,1,1,22,216,140,28,106,356
Bernalillo532,44,76,5,2,12,1,9,36,227,177,65,120,404
Bernalillo533,35,72,0,0,9,2,4,34,178,144,49,107,322
Bernalillo534,65,71,5,4,9,2,2,62,250,239,84,136,489
Bernalillo535,42,48,3,4,6,1,4,28,192,158,46,90,350
Bernalillo536,32,36,0,1,3,0,4,20,140,124,28,68,264
Bernalillo537,117,88,1,6,15,5,17,76,407,276,120,205,683
Bernalillo538,95,64,7,2,8,1,21,70,356,258,109,159,614
Bernalillo539,136,100,7,4,11,2,25,97,448,351,146,236,799
Bernalillo54,125,138,2,3,13,2,9,64,631,346,93,263,977
Bernalillo540,80,66,4,3,16,4,13,68,310,292,108,146,602
Bernalillo541,130,78,7,17,38,6,31,233,451,964,332,208,1415
Bernalillo542,66,62,1,1,10,0,2,43,233,178,57,128,411
Bernalillo543,39,51,2,1,8,0,5,35,170,124,51,90,294
Bernalillo544,57,90,1,3,14,2,3,60,269,239,83,147,508
Bernalillo545,66,68,1,3,9,4,14,41,245,205,72,134,450
Bernalillo546,70,58,2,3,11,2,8,60,227,273,86,128,500
Bernalillo547,45,55,3,1,6,1,4,42,251,169,57,100,420
Bernalillo548,105,84,3,2,8,6,16,78,343,339,113,189,682
Bernalillo549,77,85,3,6,15,1,18,64,296,277,107,162,573
Bernalillo55,98,57,1,2,9,1,1,24,347,164,38,155,511
Bernalillo550,81,65,0,1,11,0,8,49,251,196,69,146,447
Bernalillo551,24,17,1,0,5,1,0,5,91,55,12,41,146
Bernalillo552,85,104,3,7,24,3,5,79,358,367,121,189,725
Bernalillo553,117,150,14,14,39,12,24,222,550,860,325,267,1410
Bernalillo554,66,55,2,1,9,0,15,48,204,193,75,121,397
Bernalillo555,41,60,4,3,14,0,7,51,190,196,79,101,386
Bernalillo556,34,76,6,4,16,5,8,52,197,186,91,110,383
Bernalillo557,123,200,5,10,66,6,38,267,588,1023,392,323,1611
Bernalillo558,32,54,6,2,5,2,9,52,174,191,76,86,365
Bernalillo559,100,147,1,10,17,0,14,108,476,471,150,247,947
Bernalillo56,105,82,1,1,4,0,1,38,369,224,45,187,593
Bernalillo560,108,81,7,2,17,4,22,135,414,565,187,189,979
Bernalillo561,79,82,5,2,19,2,21,73,310,317,122,161,627
Bernalillo562,161,112,7,3,18,4,35,90,549,346,157,273,895
Bernalillo563,105,71,5,6,24,4,21,101,329,398,161,176,727
Bernalillo564,50,44,2,1,9,1,10,61,167,201,84,94,368
Bernalillo565,66,45,5,0,8,1,11,84,227,248,109,111,475
Bernalillo566,124,85,6,3,22,3,24,123,398,453,181,209,851
Bernalillo567,13,7,2,1,2,2,5,10,44,55,22,20,99
Bernalillo568,101,53,5,2,18,1,25,179,336,533,230,154,869
Bernalillo569,196,100,9,4,30,5,36,148,581,465,232,296,1046
Bernalillo57,131,75,2,4,10,2,8,88,463,381,114,206,844
Bernalillo570,90,97,3,9,19,1,6,99,318,334,137,187,652
Bernalillo571,95,125,2,8,22,0,10,80,367,421,122,220,788
Bernalillo572,42,45,0,4,9,0,2,53,145,171,68,87,316
Bernalillo573,102,105,8,5,44,7,22,158,380,486,244,207,866
Bernalillo58,20,20,0,1,4,0,0,9,93,52,14,40,145
Bernalillo59,139,112,0,1,5,0,2,47,582,228,55,251,810
Bernalillo6,158,145,4,1,20,3,14,108,508,377,150,303,885
Bernalillo60,109,125,1,1,7,0,3,42,510,264,54,234,774
Bernalillo601,80,49,6,4,12,0,16,87,275,321,125,129,596
Bernalillo602,120,89,5,3,17,0,37,208,509,770,270,209,1279
Bernalillo603,289,171,12,7,27,13,56,282,1097,982,397,460,2079
Bernalillo61,109,80,0,0,2,1,2,14,295,101,19,189,396
Bernalillo62,80,71,1,0,5,2,3,3,231,70,14,151,301
Bernalillo63,52,49,1,0,2,1,1,14,189,55,19,101,244
Bernalillo64,40,51,0,0,4,0,0,9,131,43,13,91,174
Bernalillo65,96,90,2,0,4,0,3,21,301,142,30,186,443
Bernalillo66,94,77,0,1,9,0,2,28,290,137,40,171,427
Bernalillo67,115,76,3,0,5,1,3,15,381,93,27,191,474
Bernalillo68,85,124,3,7,10,0,10,110,490,457,140,209,947
Bernalillo69,127,126,4,4,30,3,12,109,634,641,162,253,1275
Bernalillo7,192,133,4,1,8,4,9,81,574,389,107,325,963
Bernalillo70,151,134,3,4,15,2,15,76,639,479,115,285,1118
Bernalillo71,106,96,4,0,5,0,1,29,411,139,39,202,550
Bernalillo72,65,49,4,0,0,0,1,6,226,58,11,114,284
Bernalillo73,163,129,0,3,17,0,4,50,409,269,74,292,678
Bernalillo74,80,72,1,4,5,0,0,25,280,159,35,152,439
Bernalillo75,71,42,3,1,0,1,1,11,183,78,17,113,261
Bernalillo76,82,90,2,3,5,0,3,26,248,155,39,172,403
Bernalillo77,84,72,1,0,5,0,0,28,272,157,34,156,429
Bernalillo78,103,131,4,3,16,3,7,81,570,401,114,234,971
Bernalillo79,157,99,6,5,20,4,10,143,582,597,188,256,1179
Bernalillo8,47,49,1,0,3,0,2,20,170,110,26,96,280
Bernalillo80,106,126,3,8,17,4,7,95,555,509,134,232,1064
Bernalillo81,185,171,6,8,26,3,15,148,851,727,206,356,1578
Bernalillo82,109,98,8,5,20,2,15,101,406,395,151,207,801
Bernalillo83,196,166,4,9,20,5,15,139,729,562,192,362,1291
Bernalillo84,106,87,0,5,21,2,4,66,454,432,98,193,886
Bernalillo85,195,133,4,9,28,2,19,199,715,768,261,328,1483
Bernalillo86,83,72,1,3,6,0,2,49,276,209,61,155,485
Bernalillo87,71,98,1,2,8,0,4,53,350,307,68,169,657
Bernalillo88,54,52,1,2,6,1,3,41,257,148,54,106,405
Bernalillo89,33,44,0,0,7,2,1,40,199,185,50,77,384
Bernalillo9,70,73,1,6,4,2,4,45,250,192,62,143,442
Bernalillo90,106,89,0,0,8,2,3,34,405,200,47,195,605
Bernalillo91,163,115,4,3,19,0,1,84,371,321,111,278,692
Bernalillo92,97,92,2,4,15,1,6,56,307,229,84,189,536
Bernalillo93,130,97,0,0,7,0,2,19,464,180,28,227,644
Bernalillo94,38,34,0,0,1,0,1,10,133,43,12,72,176
Bernalillo95,52,40,0,0,0,0,0,4,222,31,4,92,253
Bernalillo96,92,65,5,3,8,0,0,45,289,195,61,157,484
Bernalillo97,121,129,8,3,13,5,4,60,400,329,93,250,729
Bernalillo98,98,83,0,1,2,0,1,21,377,154,25,181,531
Bernalillo99,118,116,0,0,8,1,5,57,370,274,71,234,644
Catron1,30,36,3,3,6,1,2,79,76,262,94,66,338
Catron2,20,35,1,7,13,2,4,117,74,339,144,55,413
Catron3,20,40,6,6,7,1,2,74,90,185,96,60,275
Catron4,20,5,0,1,9,1,1,63,43,163,75,25,206
Catron5,24,56,4,5,25,1,3,137,124,436,175,80,560
Catron6,2,11,1,0,8,0,2,36,20,79,47,13,99
Chaves1,11,13,6,3,10,1,0,94,62,314,114,24,376
Chaves10,16,13,3,3,16,0,9,195,71,505,226,29,576
Chaves101,27,30,2,2,19,0,8,165,189,537,196,57,726
Chaves102,35,25,3,9,18,0,3,108,142,376,141,60,518
Chaves103,10,8,0,2,9,0,3,38,41,137,52,18,178
Chaves104,0,2,0,1,9,0,1,33,1,74,44,2,75
Chaves11,30,26,10,13,30,0,18,173,125,565,244,56,690
Chaves12,5,13,6,3,13,1,2,100,32,284,125,18,316
Chaves13,29,26,2,2,12,1,1,58,137,258,76,55,395
Chaves14,27,25,4,5,11,2,3,44,134,244,69,52,378
Chaves15,20,12,1,3,2,2,6,53,74,152,67,32,226
Chaves16,17,12,2,5,14,0,3,66,77,180,90,29,257
Chaves2,28,13,1,5,7,0,4,85,91,276,102,41,367
Chaves21,60,29,10,9,34,2,18,211,181,583,284,89,764
Chaves22,41,40,1,4,8,2,2,86,144,314,103,81,458
Chaves23,21,14,1,0,9,2,1,48,92,180,61,35,272
Chaves24,11,6,0,1,5,0,1,28,68,101,35,17,169
Chaves25,22,20,1,1,7,0,2,22,80,135,33,42,215
Chaves3,33,27,5,3,18,3,3,77,104,306,109,60,410
Chaves31,16,27,1,4,3,0,2,50,126,213,60,43,339
Chaves32,14,16,1,2,2,0,0,14,70,97,19,30,167
Chaves33,17,26,1,2,1,0,2,38,106,157,44,43,263
Chaves34,15,19,1,1,2,0,1,16,84,79,21,34,163
Chaves35,25,12,4,2,10,1,3,31,93,170,51,37,263
Chaves36,23,16,4,3,18,3,5,119,100,390,152,39,490
Chaves4,34,21,3,6,16,0,4,72,110,257,101,55,367
Chaves41,40,26,1,4,23,1,6,149,149,526,184,66,675
Chaves42,15,23,1,4,5,0,0,18,86,95,28,38,181
Chaves43,26,14,1,0,5,0,1,21,117,95,28,40,212
Chaves44,0,3,0,0,2,0,0,13,3,17,15,3,20
Chaves45,0,0,0,0,0,0,0,2,0,15,2,0,15
Chaves46,0,0,0,2,1,0,2,22,9,79,27,0,88
Chaves47,0,0,0,0,0,0,0,2,0,6,2,0,6
Chaves5,33,33,9,13,47,2,13,269,194,777,353,66,971
Chaves51,15,8,2,0,3,0,0,2,68,57,7,23,125
Chaves52,26,20,0,2,10,0,1,49,127,188,62,46,315
Chaves6,18,24,4,8,7,2,4,67,106,296,92,42,402
Chaves61,25,10,0,1,1,0,0,5,95,42,7,35,137
Chaves62,28,15,0,0,0,0,0,10,140,75,10,43,215
Chaves63,65,29,1,0,6,0,5,23,285,172,35,94,457
Chaves7,35,13,4,3,18,1,14,141,106,411,181,48,517
Chaves71,16,9,3,7,10,1,6,63,58,243,90,25,301
Chaves72,25,20,3,4,11,0,1,74,194,266,93,45,460
Chaves73,10,10,0,1,10,0,1,34,55,165,46,20,220
Chaves81,14,15,1,0,1,1,0,16,60,96,19,29,156
Chaves82,20,28,5,3,12,0,0,35,100,174,55,48,274
Chaves83,13,14,3,2,5,0,0,46,53,154,56,27,207
Chaves84,34,17,2,5,10,0,3,53,123,254,73,51,377
Chaves85,21,7,1,1,5,0,3,53,84,183,63,28,267
Chaves9,35,20,5,6,16,2,19,175,124,530,223,55,654
Chaves90,22,11,0,1,8,0,1,33,89,123,43,33,212
Chaves91,37,23,0,10,9,0,10,63,170,303,92,60,473
Chaves92,18,15,2,2,4,0,1,34,65,155,43,33,220
Chaves93,37,29,3,2,19,0,4,94,159,323,122,66,482
Chaves94,23,25,0,2,2,0,2,28,181,168,34,48,349
Cibola1,2,7,0,0,3,0,0,42,10,98,45,9,108
Cibola10,77,77,1,3,9,0,0,34,149,166,47,154,315
Cibola11,127,127,2,2,5,1,10,48,231,239,68,254,470
Cibola12,45,62,2,0,5,1,1,19,105,125,28,107,230
Cibola13,64,55,0,0,2,0,2,15,108,113,19,119,221
Cibola14,43,78,0,2,14,0,2,59,100,273,77,121,373
Cibola15,143,137,3,5,13,2,1,78,252,396,102,280,648
Cibola16,57,57,1,1,8,0,2,36,119,156,48,114,275
Cibola17,148,79,2,1,3,1,0,8,430,54,15,227,484
Cibola18,33,34,0,1,0,0,1,2,96,44,4,67,140
Cibola19,19,26,1,2,2,0,0,19,46,103,24,45,149
Cibola2,52,46,1,0,6,0,1,2,96,65,10,98,161
Cibola20,45,34,0,2,4,1,2,15,193,55,24,79,248
Cibola21,19,19,0,0,2,0,1,3,108,31,6,38,139
Cibola22,34,27,4,0,4,1,1,5,121,21,15,61,142
Cibola23,12,3,0,0,1,0,1,1,39,5,3,15,44
Cibola24,40,23,1,3,1,0,0,4,122,24,9,63,146
Cibola25,30,15,1,0,6,0,0,3,76,25,10,45,101
Cibola3,20,19,0,0,1,0,0,9,24,38,10,39,62
Cibola4,22,39,0,1,14,0,3,51,52,208,69,61,260
Cibola5,256,210,4,4,22,3,3,45,639,186,81,466,825
Cibola6,8,13,0,2,3,0,0,17,30,53,22,21,83
Cibola7,75,104,3,0,7,1,2,53,137,229,66,179,366
Cibola8,98,73,4,0,8,1,1,34,186,153,48,171,339
Cibola9,124,136,2,2,8,0,6,75,272,335,93,260,607
Colfax1,99,121,4,7,18,1,18,149,403,561,197,220,964
Colfax10,9,7,0,4,3,0,0,18,18,73,25,16,91
Colfax11,18,25,1,3,2,0,0,11,50,57,17,43,107
Colfax12,25,35,0,1,1,0,1,12,68,66,15,60,134
Colfax13,20,18,0,1,2,0,0,9,40,33,12,38,73
Colfax14,36,28,2,0,3,0,4,23,59,80,32,64,139
Colfax15,54,48,1,4,2,3,1,35,96,163,46,102,259
Colfax16,97,77,1,5,4,0,3,51,191,241,64,174,432
Colfax17,59,33,0,1,3,0,1,13,104,76,18,92,180
Colfax18,27,13,0,0,0,0,0,8,45,33,8,40,78
Colfax19,30,8,0,0,0,1,0,3,50,20,4,38,70
Colfax2,63,45,2,2,7,2,2,27,141,117,42,108,258
Colfax20,68,35,0,0,4,0,1,11,118,82,16,103,200
Colfax21,82,68,0,3,9,1,2,20,167,170,35,150,337
Colfax22,70,57,1,2,12,2,9,71,146,274,97,127,420
Colfax3,31,25,0,4,13,0,7,18,95,110,42,56,205
Colfax4,39,33,2,1,10,0,0,25,97,143,38,72,240
Colfax5,81,45,4,7,13,2,10,49,170,181,85,126,351
Colfax7,41,22,1,1,4,0,2,17,71,105,25,63,176
Curry1,2,3,0,2,7,0,3,41,3,90,53,5,93
Curry10,7,19,3,1,9,0,6,76,40,256,95,26,296
Curry11,33,49,5,5,19,1,3,130,178,456,163,82,634
Curry12,29,39,1,1,12,1,2,69,152,302,86,68,454
Curry13,17,32,1,2,13,1,3,72,80,244,92,49,324
Curry14,11,24,2,3,12,2,6,70,79,295,95,35,374
Curry15,23,29,2,5,4,0,4,43,98,254,58,52,352
Curry16,0,2,0,0,0,0,3,3,0,32,6,2,32
Curry17,25,23,1,10,23,0,9,123,103,431,166,48,534
Curry18,62,47,9,22,35,4,11,321,234,1013,402,109,1247
Curry19,34,34,4,8,29,2,13,210,129,647,266,68,776
Curry2,6,5,0,2,9,0,2,57,8,129,70,11,137
Curry20,28,33,1,8,6,0,2,32,126,186,49,61,312
Curry21,17,37,4,5,5,1,5,63,135,229,83,54,364
Curry22,17,18,1,3,3,0,2,11,67,87,20,35,154
Curry23,17,20,5,6,11,0,9,148,49,328,179,37,377
Curry24,39,45,6,7,18,1,8,167,193,576,207,84,769
Curry25,29,9,1,0,5,0,0,9,105,53,15,38,158
Curry26,14,11,1,0,2,0,0,10,70,76,13,25,146
Curry27,7,7,0,0,0,0,1,13,44,51,14,14,95
Curry28,11,13,0,1,3,0,1,13,62,73,18,24,135
Curry29,12,9,0,2,2,0,0,17,71,103,21,21,174
Curry3,2,2,0,0,2,0,1,33,13,113,36,4,126
Curry30,6,9,2,0,12,0,2,49,28,220,65,15,248
Curry31,1,18,0,0,7,0,1,24,46,134,32,19,180
Curry32,10,23,3,1,9,1,3,80,50,211,97,33,261
Curry33,17,14,1,12,9,0,2,105,80,325,129,31,405
Curry34,0,8,3,2,3,0,0,39,4,89,47,8,93
Curry35,15,21,3,9,10,2,2,123,48,396,149,36,444
Curry36,2,5,1,1,8,0,2,43,21,137,55,7,158
Curry37,32,39,8,13,12,3,10,159,133,495,205,71,628
Curry4,8,26,3,9,27,0,1,98,30,340,138,34,370
Curry5,7,19,1,1,5,1,2,42,49,163,52,26,212
Curry6,22,10,0,0,5,1,0,5,100,47,11,32,147
Curry7,30,21,1,0,2,0,1,9,151,79,13,51,230
Curry8,42,21,1,1,13,1,3,39,175,193,58,63,368
Curry9,43,25,2,3,4,2,3,47,167,182,61,68,349
De Baca1,5,5,0,0,3,0,1,23,7,68,27,10,75
De Baca2,34,65,3,7,15,0,8,77,59,335,110,99,394
De Baca3,32,32,1,3,3,0,4,44,65,178,55,64,243
De Baca4,25,12,0,0,0,0,0,7,62,39,7,37,101
Dona Ana1,40,21,1,3,4,0,3,31,128,130,42,61,258
Dona Ana10,62,30,0,1,7,0,0,16,415,104,24,92,519
Dona Ana100,50,49,6,3,14,1,6,49,186,243,79,99,429
Dona Ana101,90,65,6,3,15,2,9,51,394,256,86,155,650
Dona Ana102,225,156,12,11,23,7,34,207,764,809,294,381,1573
Dona Ana103,65,75,0,5,8,0,5,41,278,195,59,140,473
Dona Ana104,73,53,0,2,5,2,3,38,202,136,50,126,338
Dona Ana105,144,123,3,4,20,1,8,72,667,545,108,267,1212
Dona Ana106,195,118,5,8,17,5,25,117,657,531,177,313,1188
Dona Ana107,82,57,4,4,6,1,1,126,264,387,142,139,651
Dona Ana108,124,105,5,2,8,0,11,93,433,316,119,229,749
Dona Ana109,139,165,5,8,30,2,11,101,670,570,157,304,1240
Dona Ana11,90,46,0,1,3,0,0,10,557,86,14,136,643
Dona Ana110,133,76,3,5,17,1,18,120,447,456,164,209,903
Dona Ana111,4,8,0,3,4,1,2,16,21,76,26,12,97
Dona Ana112,191,124,4,8,34,4,29,154,726,784,233,315,1510
Dona Ana113,78,82,2,1,5,2,10,57,274,251,77,160,525
Dona Ana114,118,81,3,3,7,1,12,91,369,375,117,199,744
Dona Ana115,45,35,4,4,16,2,16,61,148,273,103,80,421
Dona Ana116,87,58,6,3,14,3,9,57,340,285,92,145,625
Dona Ana117,81,72,5,5,12,0,8,35,461,297,65,153,758
Dona Ana118,71,65,0,4,10,1,6,58,340,297,79,136,637
Dona Ana119,42,36,2,3,6,0,4,30,254,169,45,78,423
Dona Ana12,123,88,1,1,3,0,1,20,789,180,26,211,969
Dona Ana120,5,7,0,1,2,2,0,4,42,33,9,12,75
Dona Ana13,279,111,0,1,1,0,1,2,1211,100,5,390,1311
Dona Ana14,145,88,3,2,24,0,8,113,669,713,150,233,1382
Dona Ana15,173,129,2,4,10,2,4,54,901,483,76,302,1384
Dona Ana16,80,27,0,1,2,1,1,31,315,147,36,107,462
Dona Ana17,109,62,4,1,9,0,3,25,355,203,42,171,558
Dona Ana18,143,70,3,3,11,0,6,42,410,169,65,213,579
Dona Ana19,108,96,1,1,11,0,6,106,378,458,125,204,836
Dona Ana2,40,32,0,2,6,0,2,26,161,104,36,72,265
Dona Ana20,85,69,2,3,12,1,3,59,332,251,80,154,583
Dona Ana21,106,63,6,3,7,3,24,118,300,390,161,169,690
Dona Ana22,113,99,4,1,13,1,10,53,491,393,82,212,884
Dona Ana23,73,57,0,2,2,0,1,26,264,123,31,130,387
Dona Ana24,61,56,1,1,4,0,9,29,280,170,44,117,450
Dona Ana25,54,49,1,1,6,0,4,22,200,98,34,103,298
Dona Ana26,117,85,5,7,15,4,10,83,399,360,124,202,759
Dona Ana27,62,43,1,1,6,0,1,13,247,93,22,105,340
Dona Ana28,112,61,1,1,7,1,5,7,358,97,22,173,455
Dona Ana29,41,28,0,2,0,0,0,8,134,47,10,69,181
Dona Ana3,27,17,1,1,1,0,1,21,133,103,25,44,236
Dona Ana30,54,64,1,2,3,1,3,18,199,94,28,118,293
Dona Ana31,69,65,5,4,3,3,0,16,250,131,31,134,381
Dona Ana32,19,14,0,0,1,0,0,0,77,14,1,33,91
Dona Ana33,75,64,0,1,6,0,3,30,247,116,40,139,363
Dona Ana34,104,69,3,1,8,0,4,25,420,187,41,173,607
Dona Ana35,33,53,2,1,0,0,2,5,192,52,10,86,244
Dona Ana36,29,25,0,1,1,0,0,5,127,49,7,54,176
Dona Ana37,82,76,0,1,5,0,3,20,247,79,29,158,326
Dona Ana38,64,45,0,5,0,0,3,15,338,149,23,109,487
Dona Ana39,55,52,3,2,3,0,6,18,225,123,32,107,348
Dona Ana4,131,65,1,1,4,0,2,17,364,129,25,196,493
Dona Ana40,56,73,3,6,5,2,9,36,279,195,61,129,474
Dona Ana41,48,37,2,1,0,0,0,10,157,53,13,85,210
Dona Ana42,35,23,0,0,0,1,0,11,133,40,12,58,173
Dona Ana43,44,37,2,2,3,0,0,8,184,61,15,81,245
Dona Ana44,52,62,0,0,3,0,6,15,227,83,24,114,310
Dona Ana45,48,56,2,0,3,0,1,11,208,83,17,104,291
Dona Ana46,36,40,2,2,3,0,2,17,173,84,26,76,257
Dona Ana47,56,46,0,3,6,0,2,12,247,98,23,102,345
Dona Ana48,61,56,2,0,4,0,4,14,307,126,24,117,433
Dona Ana49,44,51,3,2,4,3,5,33,198,113,50,95,311
Dona Ana5,60,60,0,6,14,1,2,50,315,235,73,120,550
Dona Ana50,32,25,1,1,3,0,3,6,128,49,14,57,177
Dona Ana51,58,54,0,3,9,0,5,17,220,112,34,112,332
Dona Ana52,63,110,4,3,9,2,4,29,373,168,51,173,541
Dona Ana53,32,76,4,0,8,1,6,10,253,111,29,108,364
Dona Ana54,6,35,0,0,5,0,0,2,131,50,7,41,181
Dona Ana55,62,85,6,5,4,1,10,34,308,200,60,147,508
Dona Ana56,159,141,4,8,10,1,14,39,459,296,76,300,755
Dona Ana57,69,74,5,1,9,1,7,33,258,166,56,143,424
Dona Ana58,1,28,1,0,1,0,1,2,154,79,5,29,233
Dona Ana59,159,89,5,5,29,3,15,119,576,599,176,248,1175
Dona Ana6,11,20,1,2,6,1,1,16,82,141,27,31,223
Dona Ana60,10,11,2,0,2,0,0,10,67,59,14,21,126
Dona Ana61,90,100,5,2,17,0,7,57,433,271,88,190,704
Dona Ana62,138,118,3,7,31,2,12,97,603,619,152,256,1222
Dona Ana63,81,54,0,6,14,3,10,94,279,319,127,135,598
Dona Ana64,26,28,1,1,3,0,3,30,120,124,38,54,244
Dona Ana65,27,25,1,0,1,0,0,19,213,85,21,52,298
Dona Ana66,88,99,0,3,15,1,9,89,541,423,117,187,964
Dona Ana67,143,152,2,7,18,1,15,102,692,486,145,295,1178
Dona Ana68,31,60,2,2,6,0,5,17,187,105,32,91,292
Dona Ana69,59,64,1,2,3,0,3,25,238,151,34,123,389
Dona Ana7,68,64,1,2,16,2,5,45,255,251,71,132,506
Dona Ana70,40,26,2,3,4,1,1,17,169,101,28,66,270
Dona Ana71,79,61,7,2,10,0,10,34,268,186,63,140,454
Dona Ana72,30,45,0,0,8,0,5,31,123,127,44,75,250
Dona Ana73,159,106,13,3,14,2,23,86,453,323,141,265,776
Dona Ana74,20,24,0,2,8,0,0,32,168,175,42,44,343
Dona Ana75,46,46,2,2,22,0,2,50,379,310,78,92,689
Dona Ana76,29,24,1,2,6,0,0,12,181,115,21,53,296
Dona Ana77,70,40,1,1,10,0,6,28,206,129,46,110,335
Dona Ana78,99,87,1,3,10,2,12,47,516,277,75,186,793
Dona Ana79,73,45,2,0,10,0,2,14,336,136,28,118,472
Dona Ana8,63,63,1,1,5,0,1,7,523,104,15,126,627
Dona Ana80,85,32,5,1,2,0,2,2,421,47,12,117,468
Dona Ana81,8,15,0,0,2,0,0,10,62,92,12,23,154
Dona Ana82,90,41,1,1,7,0,1,19,282,111,29,131,393
Dona Ana83,186,170,10,7,27,3,13,124,611,482,184,356,1093
Dona Ana84,75,80,3,5,14,1,4,43,224,238,70,155,462
Dona Ana85,68,61,3,4,16,0,8,50,263,228,81,129,491
Dona Ana86,151,109,2,7,19,3,18,101,477,473,150,260,950
Dona Ana87,108,81,12,6,18,5,14,129,293,505,184,189,798
Dona Ana88,42,30,0,3,3,0,2,19,115,72,27,72,187
Dona Ana89,93,67,4,5,16,1,8,66,261,228,100,160,489
Dona Ana9,19,18,0,0,0,0,0,9,156,47,9,37,203
Dona Ana90,79,58,2,5,8,1,1,33,251,179,50,137,430
Dona Ana91,63,53,0,2,7,0,3,29,228,140,41,116,368
Dona Ana92,20,11,0,0,3,1,0,2,90,24,6,31,114
Dona Ana93,23,15,0,0,1,0,0,3,104,26,4,38,130
Dona Ana94,22,51,0,0,3,0,2,5,195,68,10,73,263
Dona Ana95,10,1,0,0,0,0,0,11,47,51,11,11,98
Dona Ana96,74,44,1,3,14,0,10,41,275,248,69,118,523
Dona Ana97,199,53,0,0,0,0,1,2,701,82,3,252,783
Dona Ana98,53,40,1,2,8,2,7,30,184,221,50,93,405
Dona Ana99,86,90,4,8,24,2,9,79,337,385,126,176,722
Eddy1,36,32,2,6,31,0,1,119,91,443,159,68,534
Eddy10,70,18,0,1,3,0,1,15,234,126,20,88,360
Eddy11,38,26,0,1,2,0,0,13,140,84,16,64,224
Eddy12,21,8,1,0,2,0,0,7,53,43,10,29,96
Eddy13,69,34,0,0,2,1,2,27,216,183,32,103,399
Eddy14,22,10,0,0,2,0,1,13,117,90,16,32,207
Eddy15,55,33,0,1,8,0,1,32,151,158,42,88,309
Eddy16,48,42,1,9,10,0,5,49,160,294,74,90,454
Eddy17,68,50,3,5,15,0,8,51,190,340,82,118,530
Eddy18,37,48,3,4,17,0,4,78,132,327,106,85,459
Eddy19,35,48,2,6,10,1,7,110,120,293,136,83,413
Eddy2,98,62,1,2,23,0,2,74,266,337,102,160,603
Eddy20,26,37,1,7,6,1,3,55,98,255,73,63,353
Eddy21,24,27,3,2,4,0,2,35,74,152,46,51,226
Eddy23,42,24,2,1,8,0,1,41,146,217,53,66,363
Eddy25,26,23,1,1,4,0,0,51,69,169,57,49,238
Eddy26,37,44,1,2,11,0,0,55,123,263,69,81,386
Eddy27,74,58,6,11,23,1,20,132,214,499,193,132,713
Eddy28,49,44,3,6,25,1,17,126,147,527,178,93,674
Eddy29,1,1,0,1,1,0,0,9,1,27,11,2,28
Eddy3,26,19,1,9,5,0,6,59,76,240,80,45,316
Eddy30,1,6,1,0,4,0,0,11,8,47,16,7,55
Eddy32,115,63,2,0,6,1,2,58,325,375,69,178,700
Eddy33,74,44,1,5,9,1,7,130,217,530,153,118,747
Eddy34,61,52,5,9,18,0,8,150,218,642,190,113,860
Eddy35,36,29,1,3,12,0,5,94,111,344,115,65,455
Eddy36,29,47,2,5,12,0,5,123,93,443,147,76,536
Eddy37,23,30,4,6,19,1,11,133,106,448,174,53,554
Eddy38,5,4,0,2,3,0,1,20,16,82,26,9,98
Eddy39,13,17,3,0,7,1,2,75,45,222,88,30,267
Eddy4,56,47,4,7,42,1,4,235,135,774,293,103,909
Eddy40,1,3,0,0,6,1,2,26,5,106,35,4,111
Eddy41,14,19,5,8,9,1,4,121,48,325,148,33,373
Eddy42,0,1,0,0,0,0,0,8,2,31,8,1,33
Eddy44,58,41,4,2,16,0,12,80,206,494,114,99,700
Eddy45,22,40,6,4,13,2,10,120,106,300,155,62,406
Eddy5,38,42,6,21,25,2,6,247,95,772,307,80,867
Eddy6,18,48,4,5,17,0,6,141,104,575,173,66,679
Eddy7,57,68,12,10,31,1,7,297,182,870,358,125,1052
Eddy8,22,11,4,8,26,0,5,136,44,426,179,33,470
Eddy9,26,41,0,2,9,1,0,59,149,274,71,67,423
Grant1,21,52,3,2,10,0,2,80,63,273,97,73,336
Grant10,18,37,1,0,5,0,1,11,66,86,18,55,152
Grant11,108,109,1,7,22,2,7,113,269,490,152,217,759
Grant12,146,239,10,8,20,0,21,129,523,503,188,385,1026
Grant13,169,178,2,1,19,3,13,125,445,462,163,347,907
Grant14,94,140,2,4,11,2,4,43,298,183,66,234,481
Grant15,154,98,1,4,9,2,2,36,361,200,54,252,561
Grant16,95,77,1,3,14,1,2,42,276,200,63,172,476
Grant17,30,46,2,4,3,0,1,41,92,134,51,76,226
Grant18,53,100,1,0,1,0,4,19,211,86,25,153,297
Grant19,70,58,0,0,2,1,0,10,206,62,13,128,268
Grant2,32,79,0,1,15,1,1,51,133,204,69,111,337
Grant20,100,134,3,1,6,0,0,26,319,116,36,234,435
Grant21,21,44,0,0,0,0,1,2,88,21,3,65,109
Grant22,108,112,1,1,5,0,0,30,328,143,37,220,471
Grant23,17,33,1,1,2,0,1,24,56,73,29,50,129
Grant24,70,38,2,0,1,0,0,10,148,62,13,108,210
Grant25,129,34,0,1,2,0,0,4,230,54,7,163,284
Grant26,67,40,0,0,4,0,2,5,187,63,11,107,250
Grant27,102,42,0,0,0,0,0,6,181,42,6,144,223
Grant28,119,34,0,2,2,0,0,18,256,80,22,153,336
Grant29,53,42,2,1,5,0,5,23,147,114,36,95,261
Grant3,0,5,0,0,0,0,0,6,14,8,6,5,22
Grant30,32,54,1,2,9,0,3,60,113,241,75,86,354
Grant31,1,6,0,0,0,0,0,19,5,36,19,7,41
Grant32,42,20,0,0,0,0,0,3,106,23,3,62,129
Grant33,37,48,0,2,6,0,1,35,116,179,44,85,295
Grant34,98,40,1,1,1,0,1,6,218,72,10,138,290
Grant35,1,10,0,0,3,0,3,10,7,49,16,11,56
Grant4,10,9,0,2,3,1,2,21,30,46,29,19,76
Grant5,68,108,4,1,12,0,3,79,223,331,99,176,554
Grant6,2,5,0,0,1,0,0,19,10,42,20,7,52
Grant7,47,70,0,2,2,0,5,41,133,129,50,117,262
Grant8,119,108,5,2,10,2,5,93,324,416,117,227,740
Grant9,41,21,0,0,2,0,0,14,94,65,16,62,159
Guadalupe1,99,91,1,2,10,1,1,17,246,171,32,190,417
Guadalupe2,119,94,0,1,1,0,0,19,248,147,21,213,395
Guadalupe3,71,65,3,2,8,0,0,12,176,150,25,136,326
Guadalupe4,36,13,2,0,6,0,0,6,88,50,14,49,138
Guadalupe5,74,69,1,0,5,0,0,12,212,77,18,143,289
Harding1,20,14,3,5,9,1,2,55,41,142,75,34,183
Harding2,55,32,3,6,20,0,5,52,115,169,86,87,284
Hidalgo1,135,98,2,4,11,0,3,46,197,189,66,233,386
Hidalgo2,148,56,0,1,1,0,2,14,191,70,18,204,261
Hidalgo3,186,101,1,4,4,0,0,34,268,157,43,287,425
Hidalgo4,9,22,1,3,8,1,5,47,26,156,65,31,182
Hidalgo5,19,18,0,2,2,0,0,24,44,75,28,37,119
Hidalgo6,20,28,1,5,15,3,1,120,58,263,145,48,321
Lea10,26,20,4,3,17,1,2,162,106,470,189,46,576
Lea11,19,16,2,0,4,1,2,29,116,131,38,35,247
Lea12,12,9,0,3,6,0,3,37,68,149,49,21,217
Lea13,24,25,4,7,19,2,2,135,144,454,169,49,598
Lea14,23,22,4,7,15,1,6,58,108,279,91,45,387
Lea15,31,38,7,10,29,1,9,196,109,691,252,69,800
Lea16,6,16,1,4,8,2,0,20,60,111,35,22,171
Lea17,16,10,4,1,5,0,3,43,81,159,56,26,240
Lea18,2,3,1,3,5,0,1,59,29,209,69,5,238
Lea2,0,2,0,0,3,0,0,9,2,26,12,2,28
Lea20,26,29,1,7,31,2,3,211,121,890,255,55,1011
Lea21,4,5,0,1,8,0,0,48,21,185,57,9,206
Lea22,25,25,5,7,25,0,22,178,119,764,237,50,883
Lea23,24,23,0,5,16,2,7,153,135,541,183,47,676
Lea24,17,15,4,10,18,0,6,89,59,337,127,32,396
Lea25,12,10,8,2,12,1,13,95,58,288,131,22,346
Lea26,13,15,3,6,16,1,2,116,94,556,144,28,650
Lea27,9,6,1,4,10,1,2,103,69,433,121,15,502
Lea28,11,10,0,2,10,0,0,55,56,244,67,21,300
Lea29,10,20,4,3,13,1,6,68,88,354,95,30,442
Lea3,15,25,7,4,27,1,4,140,58,411,183,40,469
Lea30,14,17,1,3,6,0,2,53,70,245,65,31,315
Lea31,30,18,0,6,9,0,0,33,154,239,48,48,393
Lea32,21,11,1,6,5,0,6,79,87,321,97,32,408
Lea33,22,20,2,4,7,1,7,51,102,281,72,42,383
Lea34,10,4,0,1,2,0,0,26,57,84,29,14,141
Lea35,9,2,0,0,0,0,0,9,74,90,9,11,164
Lea36,19,17,1,3,3,0,0,37,99,174,44,36,273
Lea41,25,17,4,8,23,2,4,126,171,499,167,42,670
Lea42,12,21,1,5,10,0,2,50,84,290,68,33,374
Lea43,7,21,2,2,4,0,2,57,89,270,67,28,359
Lea44,11,9,1,6,8,0,1,52,74,229,68,20,303
Lea51,15,6,1,4,0,0,2,16,87,84,23,21,171
Lea52,61,14,6,2,5,0,0,32,266,191,45,75,457
Lea53,34,11,0,0,1,1,0,31,228,149,33,45,377
Lea54,10,6,0,1,1,0,0,9,91,79,11,16,170
Lea55,3,7,1,0,1,0,0,2,81,53,4,10,134
Lea61,21,9,1,0,9,0,0,17,124,132,27,30,256
Lea62,4,11,1,1,4,0,0,53,36,176,59,15,212
Lea71,15,23,5,8,17,0,2,105,73,334,137,38,407
Lea72,23,42,1,8,14,0,3,134,77,437,160,65,514
Lea73,13,13,4,3,18,1,1,94,72,296,121,26,368
Lea74,3,8,2,2,3,1,1,43,33,160,52,11,193
Lincoln1,17,15,4,3,20,1,4,62,45,161,94,32,206
Lincoln10,8,11,0,1,3,0,0,27,63,117,31,19,180
Lincoln11,32,44,6,6,14,3,6,122,187,345,157,76,532
Lincoln12,14,17,2,3,19,0,1,66,70,202,91,31,272
Lincoln13,20,19,8,5,17,2,6,114,99,175,152,39,274
Lincoln14,26,29,3,7,22,3,6,108,112,325,149,55,437
Lincoln15,10,15,0,1,9,0,4,58,49,146,72,25,195
Lincoln16,18,9,2,0,6,1,7,30,38,75,46,27,113
Lincoln17,14,14,4,1,9,1,2,91,74,212,108,28,286
Lincoln18,5,9,1,4,5,0,2,22,48,67,34,14,115
Lincoln19,3,11,1,2,9,1,2,54,28,124,69,14,152
Lincoln2,15,11,4,3,24,0,3,52,81,114,86,26,195
Lincoln20,9,13,0,0,1,3,3,41,53,146,48,22,199
Lincoln21,35,30,3,2,8,0,3,126,126,312,142,65,438
Lincoln22,6,11,4,3,4,0,1,20,50,69,32,17,119
Lincoln3,39,36,4,11,25,4,9,200,143,537,253,75,680
Lincoln4,22,18,1,3,9,2,9,80,77,225,104,40,302
Lincoln5,49,26,3,7,13,4,15,237,193,631,279,75,824
Lincoln6,36,37,7,7,9,2,12,192,146,479,229,73,625
Lincoln7,42,51,4,6,17,3,19,172,238,530,221,93,768
Lincoln8,39,50,4,7,12,1,11,177,156,457,212,89,613
Lincoln9,58,51,1,1,18,0,7,130,255,447,157,109,702
Los Alamos1,97,72,3,6,18,5,20,50,304,212,102,169,516
Los Alamos10,49,70,4,0,4,1,8,11,206,70,28,119,276
Los Alamos11,106,112,5,3,16,4,21,44,434,213,93,218,647
Los Alamos12,65,94,2,5,12,2,13,45,320,136,79,159,456
Los Alamos13,62,90,4,3,7,1,6,26,350,158,47,152,508
Los Alamos14,76,74,7,6,19,3,25,49,295,195,109,150,490
Los Alamos15,192,155,8,13,22,9,26,109,668,457,187,347,1125
Los Alamos16,164,120,5,8,17,4,46,62,613,272,142,284,885
Los Alamos17,60,51,7,1,3,1,9,20,249,110,41,111,359
Los Alamos2,57,59,7,5,8,3,21,33,212,136,77,116,348
Los Alamos3,57,53,4,12,20,2,26,55,205,215,119,110,420
Los Alamos4,66,90,4,11,23,1,18,44,311,239,101,156,550
Los Alamos5,54,48,4,7,7,2,11,44,171,172,75,102,343
Los Alamos6,117,136,8,7,23,7,42,112,430,381,199,253,811
Los Alamos7,61,55,2,5,4,1,7,34,232,167,53,116,399
Los Alamos8,88,74,9,7,11,1,17,30,335,139,75,162,474
Los Alamos9,55,59,6,2,7,1,11,21,227,87,48,114,314
Luna1,32,28,2,1,6,0,0,27,116,85,36,60,201
Luna10,120,99,12,2,15,1,13,122,326,415,165,219,741
Luna11,101,57,2,4,7,1,3,46,287,175,63,158,462
Luna12,90,49,3,1,11,0,6,41,255,152,62,139,407
Luna13,75,101,5,6,24,4,10,226,269,646,275,176,915
Luna14,70,60,3,6,21,1,11,158,281,458,200,130,739
Luna2,29,37,1,4,8,1,4,90,175,304,108,66,479
Luna3,58,68,5,4,17,0,10,181,229,439,217,126,668
Luna4,62,38,1,2,6,3,3,32,342,101,47,100,443
Luna5,94,78,3,10,17,1,6,114,336,347,151,172,683
Luna6,76,60,5,0,7,3,11,63,251,216,89,136,467
Luna8,111,39,5,3,4,2,2,24,328,140,40,150,468
McKinley1,74,37,1,0,5,2,2,10,274,50,20,111,324
McKinley10,119,59,5,2,5,1,6,4,293,49,23,178,342
McKinley11,28,32,2,1,3,0,0,0,110,31,6,60,141
McKinley12,28,12,0,0,0,0,0,2,43,15,2,40,58
McKinley13,41,32,1,0,4,0,1,1,163,34,7,73,197
McKinley14,93,91,5,3,6,0,0,16,337,151,30,184,488
McKinley15,74,91,5,3,3,1,0,7,247,91,19,165,338
McKinley16,53,59,0,2,3,0,1,11,182,61,17,112,243
McKinley17,82,92,7,5,12,1,5,35,263,215,65,174,478
McKinley18,29,20,2,0,0,0,0,4,82,22,6,49,104
McKinley19,160,107,1,2,7,4,1,6,362,105,21,267,467
McKinley2,39,31,0,0,3,0,1,6,113,65,10,70,178
McKinley20,122,63,1,3,7,1,0,24,314,108,36,185,422
McKinley21,93,66,4,1,3,0,1,17,255,99,26,159,354
McKinley22,107,50,5,1,3,1,2,8,229,89,20,157,318
McKinley23,123,67,2,3,0,0,2,13,315,93,20,190,408
McKinley24,118,83,4,2,6,1,0,14,316,125,27,201,441
McKinley25,218,143,4,3,11,0,0,29,532,206,47,361,738
McKinley26,24,25,2,2,17,0,1,42,65,181,64,49,246
McKinley27,136,43,6,3,8,0,2,3,567,22,22,179,589
McKinley28,48,24,2,3,1,0,0,3,227,19,9,72,246
McKinley29,74,22,1,0,8,0,2,0,325,15,11,96,340
McKinley3,35,22,2,3,10,0,3,9,87,62,27,57,149
McKinley30,123,38,3,1,3,0,0,0,486,31,7,161,517
McKinley31,48,33,1,3,9,0,1,20,159,118,34,81,277
McKinley32,36,25,2,1,3,0,0,11,120,66,17,61,186
McKinley33,112,65,2,0,1,0,0,6,286,109,9,177,395
McKinley34,54,42,0,0,1,0,2,2,135,58,5,96,193
McKinley35,49,37,0,0,3,1,0,11,140,49,15,86,189
McKinley36,15,11,0,1,1,0,0,3,43,17,5,26,60
McKinley37,32,20,0,0,0,0,0,7,75,29,7,52,104
McKinley38,45,34,1,0,2,0,0,2,114,47,5,79,161
McKinley39,49,73,1,0,3,0,0,17,181,91,21,122,272
McKinley4,123,66,1,1,4,1,0,2,262,47,9,189,309
McKinley40,31,38,0,0,1,0,2,4,104,59,7,69,163
McKinley41,92,55,1,0,8,0,0,8,228,83,17,147,311
McKinley42,17,31,0,1,3,0,3,21,67,67,28,48,134
McKinley43,99,126,2,3,8,0,4,35,235,237,52,225,472
McKinley44,48,57,2,3,2,0,2,20,97,124,29,105,221
McKinley45,45,70,0,2,7,1,1,31,152,156,42,115,308
McKinley46,104,87,2,1,7,0,4,36,204,206,50,191,410
McKinley47,36,22,2,0,2,1,0,7,111,47,12,58,158
McKinley48,116,81,2,2,11,1,4,17,349,147,37,197,496
McKinley49,108,99,4,4,12,1,11,58,296,238,90,207,534
McKinley5,185,128,8,1,10,1,3,20,501,104,43,313,605
McKinley50,20,15,1,1,1,0,1,8,63,53,12,35,116
McKinley51,74,58,2,0,2,0,2,1,224,33,7,132,257
McKinley52,27,25,3,0,1,0,3,31,71,113,38,52,184
McKinley53,147,68,2,1,6,0,3,1,330,29,13,215,359
McKinley54,102,41,6,2,8,0,1,10,248,80,27,143,328
McKinley55,57,42,2,1,4,0,3,9,163,55,19,99,218
McKinley56,64,62,4,0,6,2,3,29,195,178,44,126,373
McKinley57,86,28,3,1,5,0,0,3,194,33,12,114,227
McKinley58,68,64,3,1,5,1,2,21,216,138,33,132,354
McKinley59,32,29,0,1,1,0,2,21,89,69,25,61,158
McKinley6,214,104,3,3,8,1,0,8,517,79,23,318,596
McKinley60,47,46,2,1,6,0,0,2,147,31,11,93,178
McKinley61,59,27,1,0,0,0,0,1,117,12,2,86,129
McKinley62,49,24,2,1,2,0,0,3,122,30,8,73,152
McKinley7,136,116,4,2,5,0,1,13,360,58,25,252,418
McKinley8,94,42,2,1,10,0,1,4,196,27,18,136,223
McKinley9,104,61,2,3,4,1,1,4,278,48,15,165,326
Mora1,180,120,0,1,5,0,1,25,295,110,32,300,405
Mora10,53,40,1,0,7,0,0,1,78,47,9,93,125
Mora11,72,41,1,1,1,0,0,17,127,61,20,113,188
Mora2,192,105,1,0,6,0,0,19,269,93,26,297,362
Mora3,67,61,0,1,7,1,1,19,123,64,29,128,187
Mora4,117,63,4,3,10,1,1,4,158,56,23,180,214
Mora5,84,39,1,1,1,0,1,11,131,72,15,123,203
Mora6,47,33,2,0,3,0,0,5,64,43,10,80,107
Mora7,59,26,0,0,6,0,0,3,98,22,9,85,120
Mora8,85,63,0,0,4,2,1,15,144,66,22,148,210
Mora9,28,12,1,0,1,0,0,4,49,31,6,40,80
Otero1,27,24,0,0,1,0,0,6,409,102,7,51,511
Otero10,82,64,5,6,50,4,15,249,299,899,329,146,1198
Otero11,49,52,2,1,6,0,0,5,348,59,14,101,407
Otero12,60,37,3,2,19,2,10,91,171,413,127,97,584
Otero13,56,51,2,4,16,3,4,61,203,252,90,107,455
Otero14,72,61,7,5,27,2,11,138,201,556,190,133,757
Otero15,30,28,4,4,18,1,11,136,140,496,174,58,636
Otero16,0,9,0,0,3,0,1,9,60,110,13,9,170
Otero17,29,25,3,4,15,2,5,124,214,407,153,54,621
Otero18,119,66,9,16,47,9,20,354,416,1197,455,185,1613
Otero19,32,23,2,3,5,0,2,9,136,56,21,55,192
Otero2,0,3,0,1,1,0,0,8,3,23,10,3,26
Otero20,31,14,0,3,1,1,1,22,97,75,28,45,172
Otero21,34,43,7,11,21,2,10,141,236,513,192,77,749
Otero22,19,19,2,3,6,0,3,34,90,157,48,38,247
Otero23,30,29,2,1,11,1,4,43,103,170,62,59,273
Otero24,53,56,5,6,24,4,15,158,197,449,212,109,646
Otero25,29,30,2,6,22,4,11,88,136,340,133,59,476
Otero26,19,25,4,3,8,3,8,64,118,180,90,44,298
Otero27,26,41,6,1,23,0,3,83,111,286,116,67,397
Otero28,44,52,5,7,28,3,12,145,190,474,200,96,664
Otero29,52,39,11,9,28,1,15,162,231,549,226,91,780
Otero3,0,0,0,0,9,0,0,7,0,23,16,0,23
Otero30,33,21,2,5,8,1,2,34,105,152,52,54,257
Otero31,25,18,3,1,4,0,4,32,93,117,44,43,210
Otero32,24,34,2,2,9,1,1,33,137,136,48,58,273
Otero33,38,33,2,4,11,0,4,45,128,176,66,71,304
Otero34,23,12,5,3,12,1,7,57,88,170,85,35,258
Otero35,34,32,6,4,20,1,7,170,125,517,208,66,642
Otero36,42,22,4,10,12,0,8,84,164,309,118,64,473
Otero37,17,25,3,2,5,1,2,49,80,181,62,42,261
Otero38,9,8,1,0,6,2,0,13,28,69,22,17,97
Otero39,34,13,5,7,15,1,8,96,137,317,132,47,454
Otero4,2,2,1,0,10,0,1,16,5,62,28,4,67
Otero40,22,21,5,3,18,0,12,92,104,268,130,43,372
Otero41,28,29,1,1,0,0,1,13,340,105,16,57,445
Otero5,6,10,0,1,8,0,0,42,32,137,51,16,169
Otero6,2,4,0,2,13,1,4,37,3,111,57,6,114
Otero7,13,9,0,1,6,0,4,40,41,158,51,22,199
Otero8,66,81,5,10,44,3,16,216,277,761,294,147,1038
Otero9,30,45,4,7,23,2,8,101,128,355,145,75,483
Quay1,0,4,3,1,6,1,0,32,2,86,43,4,88
Quay10,59,26,1,2,5,0,1,12,127,57,21,85,184
Quay11,69,65,6,4,19,2,11,87,165,293,129,134,458
Quay12,48,49,5,3,23,0,4,74,86,230,109,97,316
Quay2,2,4,0,2,3,1,1,24,4,60,31,6,64
Quay3,22,29,2,2,8,0,1,57,38,162,70,51,200
Quay4,3,9,0,0,6,0,0,17,7,56,23,12,63
Quay5,42,59,5,5,15,1,2,146,72,509,174,101,581
Quay6,28,48,4,2,10,1,4,95,54,271,116,76,325
Quay7,90,57,1,2,6,0,3,35,222,120,47,147,342
Quay8,25,26,3,0,3,0,2,43,63,118,51,51,181
Quay9,86,69,4,1,16,1,3,76,177,250,101,155,427
Rio Arriba1,108,136,0,0,2,2,3,10,289,59,17,244,348
Rio Arriba10,172,95,2,0,5,0,0,6,326,106,13,267,432
Rio Arriba11,258,209,1,2,15,2,4,42,575,295,66,467,870
Rio Arriba12,95,62,1,1,3,1,0,7,194,93,13,157,287
Rio Arriba13,253,170,4,1,3,0,0,13,414,176,21,423,590
Rio Arriba14,146,62,2,0,2,0,1,8,247,77,13,208,324
Rio Arriba15,78,58,0,0,1,0,0,1,117,31,2,136,148
Rio Arriba16,88,72,0,0,0,0,0,7,172,60,7,160,232
Rio Arriba17,31,36,0,0,0,0,0,1,76,16,1,67,92
Rio Arriba18,89,98,0,0,2,2,0,14,148,97,18,187,245
Rio Arriba19,80,35,0,0,7,0,1,27,126,97,35,115,223
Rio Arriba2,383,210,2,0,4,0,3,18,651,185,27,593,836
Rio Arriba20,189,129,2,2,3,0,3,43,331,255,53,318,586
Rio Arriba21,18,13,2,0,0,0,0,0,33,13,2,31,46
Rio Arriba22,43,24,2,0,0,0,0,4,65,24,6,67,89
Rio Arriba23,87,56,0,0,0,1,1,2,103,42,4,143,145
Rio Arriba24,185,117,1,5,20,0,1,21,484,104,48,302,588
Rio Arriba25,5,12,0,0,3,0,1,27,25,105,31,17,130
Rio Arriba26,63,50,0,0,0,1,0,7,110,64,8,113,174
Rio Arriba27,22,13,1,0,0,0,1,1,36,19,3,35,55
Rio Arriba28,4,3,0,0,0,0,0,0,21,5,0,7,26
Rio Arriba29,0,3,0,0,0,0,1,0,3,6,1,3,9
Rio Arriba3,164,90,0,2,7,1,0,12,276,113,22,254,389
Rio Arriba30,20,15,1,0,5,0,1,12,40,74,19,35,114
Rio Arriba31,177,121,1,0,2,0,2,5,347,66,10,298,413
Rio Arriba32,68,66,3,1,1,1,0,8,168,74,14,134,242
Rio Arriba33,22,27,1,0,0,0,0,0,53,9,1,49,62
Rio Arriba34,2,1,0,0,0,0,0,0,4,0,0,3,4
Rio Arriba35,144,144,3,0,4,0,3,27,332,115,37,288,447
Rio Arriba36,309,212,3,0,8,1,3,37,571,251,52,521,822
Rio Arriba37,44,28,0,0,1,0,0,1,89,22,2,72,111
Rio Arriba38,205,146,1,1,4,0,0,15,394,133,21,351,527
Rio Arriba39,193,109,0,1,6,1,3,19,391,132,30,302,523
Rio Arriba4,203,129,0,0,3,0,3,14,407,157,20,332,564
Rio Arriba40,173,94,0,1,6,0,0,12,330,129,19,267,459
Rio Arriba41,399,144,3,1,6,0,0,5,539,61,15,543,600
Rio Arriba42,36,37,0,0,0,0,1,5,91,31,6,73,122
Rio Arriba5,147,71,2,0,4,0,2,10,214,82,18,218,296
Rio Arriba6,46,68,0,0,2,0,1,6,146,27,9,114,173
Rio Arriba7,123,87,0,2,1,0,5,13,333,71,21,210,404
Rio Arriba8,84,46,0,0,1,1,0,4,144,44,6,130,188
Rio Arriba9,87,62,0,1,3,0,5,9,177,79,18,149,256
Roosevelt1,20,26,3,5,5,3,1,18,116,131,35,46,247
Roosevelt10,26,45,5,5,7,2,11,91,149,386,121,71,535
Roosevelt11,3,10,4,3,2,0,1,48,40,183,58,13,223
Roosevelt12,22,36,4,6,2,1,6,53,126,240,72,58,366
Roosevelt13,3,17,0,2,3,0,4,10,59,70,19,20,129
Roosevelt14,17,49,2,4,7,0,2,41,116,216,56,66,332
Roosevelt15,12,7,1,1,7,0,0,24,44,133,33,19,177
Roosevelt16,9,13,1,0,11,0,0,23,36,94,35,22,130
Roosevelt17,4,19,4,5,11,0,3,55,54,267,78,23,321
Roosevelt18,12,7,5,6,17,0,5,90,44,335,123,19,379
Roosevelt2,59,37,5,7,28,1,4,194,180,560,239,96,740
Roosevelt3,3,6,0,4,0,0,0,4,11,37,8,9,48
Roosevelt4,8,11,1,1,3,1,0,65,31,209,71,19,240
Roosevelt5,4,6,5,5,2,0,1,71,19,174,84,10,193
Roosevelt6,4,20,1,3,11,0,4,74,25,242,93,24,267
Roosevelt7,10,16,1,2,8,0,1,6,53,74,18,26,127
Roosevelt8,37,24,0,2,2,0,3,12,170,94,19,61,264
Roosevelt9,29,43,5,4,20,0,9,87,181,439,125,72,620
San Juan1,114,73,3,2,14,2,5,23,398,142,49,187,540
San Juan10,47,31,7,1,8,0,1,9,221,49,26,78,270
San Juan11,60,39,6,2,9,1,6,7,214,62,31,99,276
San Juan12,70,27,0,0,3,0,0,5,177,53,8,97,230
San Juan13,113,82,5,1,19,1,4,7,329,57,37,195,386
San Juan14,50,35,2,2,4,0,0,3,135,37,11,85,172
San Juan15,78,37,2,4,4,1,1,4,236,68,16,115,304
San Juan16,77,52,9,1,11,1,3,14,318,189,39,129,507
San Juan17,21,23,1,0,2,0,1,5,78,37,9,44,115
San Juan18,74,64,4,5,19,1,2,35,290,227,66,138,517
San Juan19,16,16,1,1,1,1,1,3,86,49,8,32,135
San Juan2,79,49,4,3,6,0,3,9,328,95,25,128,423
San Juan20,75,68,6,4,16,1,7,23,396,255,57,143,651
San Juan21,27,32,3,3,23,1,0,113,166,421,143,59,587
San Juan22,68,66,5,7,20,1,3,76,300,458,112,134,758
San Juan23,39,29,5,12,18,2,6,89,134,397,132,68,531
San Juan24,11,19,3,5,25,0,7,68,55,290,108,30,345
San Juan25,23,23,2,11,18,1,6,87,85,291,125,46,376
San Juan26,25,17,0,3,10,0,0,28,118,200,41,42,318
San Juan27,32,41,1,1,12,0,2,51,234,358,67,73,592
San Juan28,13,32,1,3,6,1,3,56,96,290,70,45,386
San Juan29,23,23,3,0,16,1,4,46,111,220,70,46,331
San Juan3,77,34,3,0,8,0,1,18,280,105,30,111,385
San Juan30,30,46,7,8,16,5,11,130,165,587,177,76,752
San Juan31,75,60,13,4,35,2,30,197,249,889,281,135,1138
San Juan32,14,10,4,1,5,0,7,37,56,150,54,24,206
San Juan33,26,37,2,5,14,1,7,56,155,307,85,63,462
San Juan34,35,43,2,0,10,2,4,56,155,270,74,78,425
San Juan35,16,26,3,6,10,2,6,50,99,223,77,42,322
San Juan36,14,16,0,3,9,2,4,60,76,265,78,30,341
San Juan37,11,39,2,6,19,0,3,64,104,293,94,50,397
San Juan38,32,35,1,8,16,4,12,113,131,460,154,67,591
San Juan39,44,52,6,3,34,3,8,188,188,767,242,96,955
San Juan4,119,104,10,2,18,0,2,33,548,187,65,223,735
San Juan40,36,30,1,3,9,2,2,56,136,328,73,66,464
San Juan41,32,36,5,7,28,1,18,157,153,710,216,68,863
San Juan42,33,42,5,7,35,1,12,151,133,622,211,75,755
San Juan43,34,34,4,3,14,2,7,60,109,316,90,68,425
San Juan44,32,50,8,11,24,0,7,148,171,656,198,82,827
San Juan45,28,30,3,2,15,1,6,77,144,383,104,58,527
San Juan46,23,35,1,6,16,1,13,102,107,453,139,58,560
San Juan47,7,11,1,0,3,1,2,22,39,146,29,18,185
San Juan48,22,19,2,4,7,3,6,125,96,550,147,41,646
San Juan49,43,45,7,8,30,2,12,163,217,769,222,88,986
San Juan5,140,84,13,1,10,2,0,25,605,215,51,224,820
San Juan50,18,32,5,4,5,3,3,48,137,340,68,50,477
San Juan51,23,19,1,1,9,1,2,54,149,307,68,42,456
San Juan52,13,7,1,3,6,0,3,46,48,238,59,20,286
San Juan53,37,46,5,6,30,4,4,115,211,578,164,83,789
San Juan54,40,18,4,5,18,0,9,108,128,505,144,58,633
San Juan55,25,38,6,6,34,4,6,130,121,605,186,63,726
San Juan56,25,38,3,5,21,0,1,88,213,594,118,63,807
San Juan57,23,39,1,4,20,1,2,173,89,677,201,62,766
San Juan58,15,19,1,3,19,7,4,114,63,453,148,34,516
San Juan59,30,40,9,13,52,5,7,178,131,789,264,70,920
San Juan6,40,15,6,2,1,1,3,11,125,52,24,55,177
San Juan60,16,21,2,4,12,1,8,93,48,324,120,37,372
San Juan61,27,29,0,5,20,1,11,144,131,741,181,56,872
San Juan62,24,40,7,5,22,0,6,83,104,374,123,64,478
San Juan63,25,36,1,6,19,1,5,78,105,383,110,61,488
San Juan64,19,24,2,7,9,2,7,86,95,364,113,43,459
San Juan65,30,31,2,4,15,0,3,81,88,437,105,61,525
San Juan66,24,39,3,2,18,0,7,88,88,312,118,63,400
San Juan67,36,40,6,5,25,1,7,150,145,745,194,76,890
San Juan68,9,22,0,1,2,0,0,48,66,243,51,31,309
San Juan69,32,32,3,2,36,2,11,152,118,644,206,64,762
San Juan7,56,20,2,2,2,0,0,1,177,56,7,76,233
San Juan70,22,18,2,1,19,0,2,90,104,405,114,40,509
San Juan71,15,22,2,5,14,0,3,111,116,618,135,37,734
San Juan72,47,39,1,1,29,3,2,78,125,411,114,86,536
San Juan73,17,16,1,2,6,0,0,55,74,311,64,33,385
San Juan74,62,50,3,4,26,1,6,134,219,717,174,112,936
San Juan75,33,20,3,1,7,0,0,57,88,263,68,53,351
San Juan76,43,50,6,5,54,1,14,168,182,727,248,93,909
San Juan77,36,33,1,5,14,0,9,136,117,697,165,69,814
San Juan8,136,103,16,6,12,3,8,20,485,103,65,239,588
San Juan9,71,32,1,1,3,0,1,9,154,37,15,103,191
San Miguel1,67,70,0,0,2,0,1,2,198,34,5,137,232
San Miguel10,75,80,3,0,2,1,1,17,192,79,24,155,271
San Miguel11,36,32,0,0,0,0,0,4,90,24,4,68,114
San Miguel12,123,86,0,3,4,0,1,9,268,93,17,209,361
San Miguel13,111,77,0,1,3,0,0,9,197,50,13,188,247
San Miguel14,15,12,0,0,1,1,0,9,30,37,11,27,67
San Miguel15,10,11,0,1,4,0,0,28,23,81,33,21,104
San Miguel16,148,134,0,0,6,1,2,24,329,154,33,282,483
San Miguel17,18,21,0,0,2,0,0,0,41,7,2,39,48
San Miguel18,100,54,1,0,6,0,1,12,153,53,20,154,206
San Miguel19,203,96,0,0,2,0,0,9,316,62,11,299,378
San Miguel2,123,123,2,0,8,0,5,4,324,79,19,246,403
San Miguel20,41,13,0,0,3,0,0,3,53,22,6,54,75
San Miguel21,111,80,1,3,1,0,0,14,245,68,19,191,313
San Miguel22,43,44,2,1,6,0,1,10,138,66,20,87,204
San Miguel23,280,223,4,3,22,0,2,49,644,285,80,503,929
San Miguel24,107,71,2,1,9,1,3,15,203,79,31,178,282
San Miguel25,125,75,0,0,2,1,0,5,231,51,8,200,282
San Miguel26,276,141,0,0,4,1,1,8,533,91,14,417,624
San Miguel27,154,146,2,0,5,0,2,8,381,117,17,300,498
San Miguel28,93,66,0,0,0,0,0,10,228,85,10,159,313
San Miguel3,155,90,0,0,2,0,1,2,316,45,5,245,361
San Miguel4,253,162,1,4,4,1,6,20,552,168,36,415,720
San Miguel5,238,127,1,2,10,4,2,17,497,135,36,365,632
San Miguel6,76,51,1,1,1,0,0,6,151,64,9,127,215
San Miguel7,96,51,0,0,8,1,0,8,211,71,17,147,282
San Miguel8,314,181,3,1,6,1,3,20,611,112,34,495,723
San Miguel9,52,48,1,3,4,0,1,27,130,101,36,100,231
Sandoval1,228,115,5,3,13,3,4,62,544,294,90,343,838
Sandoval10,57,61,2,1,0,0,7,6,198,44,16,118,242
Sandoval11,216,162,4,2,14,5,15,91,600,385,131,378,985
Sandoval12,189,167,5,5,12,2,16,114,592,431,154,356,1023
Sandoval13,147,168,4,4,11,5,19,72,531,297,115,315,828
Sandoval14,100,102,0,0,1,0,1,3,211,19,5,202,230
Sandoval15,162,57,1,0,0,0,0,0,324,20,1,219,344
Sandoval16,18,30,0,2,7,0,1,26,71,54,36,48,125
Sandoval17,37,34,1,1,6,2,3,35,100,92,48,71,192
Sandoval18,43,68,5,0,12,0,4,36,138,113,57,111,251
Sandoval19,67,32,0,2,0,0,0,5,156,17,7,99,173
Sandoval2,185,138,3,3,9,0,2,22,528,188,39,323,716
Sandoval20,101,70,0,2,1,1,1,9,458,45,14,171,503
Sandoval21,43,66,2,0,8,0,5,31,97,119,46,109,216
Sandoval22,55,64,1,5,8,2,0,26,124,120,42,119,244
Sandoval23,26,40,3,0,7,0,1,31,81,106,42,66,187
Sandoval24,46,42,2,1,4,1,1,5,189,39,14,88,228
Sandoval25,178,177,0,0,5,0,2,5,491,49,12,355,540
Sandoval26,75,50,2,0,2,0,0,5,184,54,9,125,238
Sandoval27,21,16,0,0,5,0,0,20,52,47,25,37,99
Sandoval28,53,53,3,1,26,2,19,97,217,299,148,106,516
Sandoval29,75,57,0,3,4,0,1,0,155,19,8,132,174
Sandoval3,133,100,4,2,9,0,1,26,286,138,42,233,424
Sandoval30,82,86,3,6,14,1,6,90,436,467,120,168,903
Sandoval31,65,96,4,6,20,1,12,122,350,460,165,161,810
Sandoval32,38,41,3,0,7,1,4,43,148,208,58,79,356
Sandoval33,147,126,8,2,25,4,13,134,616,626,186,273,1242
Sandoval34,70,45,5,3,8,3,6,67,203,257,92,115,460
Sandoval35,49,87,1,7,12,1,6,57,261,294,84,136,555
Sandoval36,84,76,2,3,22,1,6,85,312,367,119,160,679
Sandoval37,106,149,5,10,36,1,16,144,667,900,212,255,1567
Sandoval38,76,96,1,1,14,2,2,101,325,392,121,172,717
Sandoval39,114,156,7,3,36,6,7,154,592,738,213,270,1330
Sandoval4,78,63,2,1,8,2,3,21,193,115,37,141,308
Sandoval40,76,64,2,2,16,2,6,66,346,337,94,140,683
Sandoval41,76,86,1,6,19,2,10,123,356,450,161,162,806
Sandoval42,40,54,0,1,9,0,3,52,214,285,65,94,499
Sandoval43,50,52,0,3,18,0,2,58,225,298,81,102,523
Sandoval44,56,118,2,6,18,0,5,113,344,472,144,174,816
Sandoval45,63,82,2,6,14,3,12,57,344,372,94,145,716
Sandoval46,48,67,1,1,9,1,3,52,254,226,67,115,480
Sandoval47,96,123,4,3,17,2,16,145,475,672,187,219,1147
Sandoval48,57,44,1,8,11,0,7,70,219,296,97,101,515
Sandoval49,48,69,2,4,13,0,5,61,245,309,85,117,554
Sandoval5,218,216,6,6,13,7,19,136,720,407,187,434,1127
Sandoval50,115,74,6,5,14,4,18,126,402,554,173,189,956
Sandoval51,0,0,0,0,0,0,0,0,0,0,0,0,0
Sandoval52,36,35,0,4,5,1,1,36,136,147,47,71,283
Sandoval53,165,142,3,3,21,4,11,104,568,421,146,307,989
Sandoval54,138,101,2,2,15,2,11,87,405,329,119,239,734
Sandoval55,158,102,5,3,14,2,9,117,445,351,150,260,796
Sandoval56,86,117,1,2,11,2,4,48,265,177,68,203,442
Sandoval57,56,71,1,2,8,0,7,56,223,240,74,127,463
Sandoval58,145,131,6,5,27,3,15,187,540,781,243,276,1321
Sandoval59,25,24,1,1,8,0,8,38,133,164,56,49,297
Sandoval6,76,50,1,2,4,0,3,31,181,97,41,126,278
Sandoval60,49,50,0,2,7,0,1,60,205,246,70,99,451
Sandoval61,59,55,3,6,7,2,4,53,242,255,75,114,497
Sandoval62,101,58,6,2,18,3,17,114,355,405,160,159,760
Sandoval63,43,47,1,2,15,0,6,55,238,289,79,90,527
Sandoval64,102,115,6,9,29,6,14,116,396,517,180,217,913
Sandoval65,105,93,0,4,10,0,9,83,461,425,106,198,886
Sandoval66,123,162,8,12,32,2,14,155,589,727,223,285,1316
Sandoval67,87,96,7,1,19,1,4,87,458,465,119,183,923
Sandoval68,74,142,1,4,11,1,8,104,495,594,129,216,1089
Sandoval69,79,115,1,7,19,0,4,74,434,513,105,194,947
Sandoval7,70,56,2,0,4,0,1,13,182,83,20,126,265
Sandoval70,27,54,0,7,9,1,1,52,224,243,70,81,467
Sandoval71,43,76,0,1,10,0,6,56,263,273,73,119,536
Sandoval72,107,101,4,5,40,3,8,117,598,776,177,208,1374
Sandoval73,51,43,0,1,13,6,11,63,169,292,94,94,461
Sandoval74,216,128,5,10,25,8,34,190,603,725,272,344,1328
Sandoval75,47,50,1,3,6,1,6,55,207,244,72,97,451
Sandoval76,200,121,5,3,12,5,13,78,542,370,116,321,912
Sandoval77,154,73,0,0,0,0,0,3,344,17,3,227,361
Sandoval78,17,20,1,1,7,2,8,37,66,111,56,37,177
Sandoval79,14,29,0,0,2,0,2,15,80,68,19,43,148
Sandoval8,74,54,0,0,2,0,1,2,237,21,5,128,258
Sandoval80,71,102,2,5,18,0,9,110,421,571,144,173,992
Sandoval81,58,50,5,2,25,2,12,86,269,319,132,108,588
Sandoval82,89,89,4,3,16,2,11,58,350,375,94,178,725
Sandoval83,58,68,4,3,15,1,11,130,282,484,164,126,766
Sandoval84,65,73,1,3,10,2,3,64,353,390,83,138,743
Sandoval85,47,56,0,6,16,3,11,80,297,489,116,103,786
Sandoval86,76,54,1,5,17,0,8,71,378,400,102,130,778
Sandoval9,192,66,0,0,2,1,0,1,499,20,4,258,519
Santa Fe1,207,181,2,2,18,0,3,28,512,192,53,388,704
Santa Fe10,398,213,3,1,8,0,15,67,1049,247,94,611,1296
Santa Fe11,301,388,0,3,3,3,5,27,1020,155,41,689,1175
Santa Fe12,180,191,0,0,7,0,3,22,627,154,32,371,781
Santa Fe13,248,317,3,2,8,0,6,41,937,198,60,565,1135
Santa Fe14,109,81,0,1,4,1,3,14,364,113,23,190,477
Santa Fe15,34,69,4,2,21,0,3,99,198,349,129,103,547
Santa Fe16,31,24,2,0,9,1,2,46,86,118,60,55,204
Santa Fe17,69,80,2,0,3,0,0,17,210,62,22,149,272
Santa Fe18,39,52,1,5,31,0,7,107,168,406,151,91,574
Santa Fe19,44,28,0,0,2,1,3,19,59,83,25,72,142
Santa Fe2,32,42,1,0,2,0,0,11,98,47,14,74,145
Santa Fe20,216,251,0,0,1,3,2,17,709,84,23,467,793
Santa Fe21,337,368,3,2,4,0,14,28,1085,188,51,705,1273
Santa Fe22,227,183,1,0,4,0,5,18,642,100,28,410,742
Santa Fe23,138,119,2,1,7,2,8,22,368,117,42,257,485
Santa Fe24,197,222,2,0,4,2,4,11,578,89,23,419,667
Santa Fe25,92,175,0,0,1,0,3,4,394,46,8,267,440
Santa Fe26,91,122,1,0,2,0,0,9,318,32,12,213,350
Santa Fe27,178,259,0,0,5,0,2,11,651,73,18,437,724
Santa Fe28,139,85,2,2,3,0,4,9,382,60,20,224,442
Santa Fe29,299,259,2,1,11,2,11,48,782,243,75,558,1025
Santa Fe3,121,63,1,0,0,0,1,4,213,41,6,184,254
Santa Fe30,224,171,0,0,5,2,8,25,665,120,40,395,785
Santa Fe31,86,125,0,0,1,0,3,20,330,79,24,211,409
Santa Fe32,287,329,1,0,5,0,3,15,797,123,24,616,920
Santa Fe33,144,271,1,0,2,0,2,11,586,86,16,415,672
Santa Fe34,255,299,2,3,8,1,4,17,758,125,35,554,883
Santa Fe35,37,69,0,0,0,1,2,11,187,38,14,106,225
Santa Fe36,135,97,1,1,3,0,6,11,389,52,22,232,441
Santa Fe37,215,174,3,3,4,3,9,21,574,102,43,389,676
Santa Fe38,262,200,5,1,6,2,4,39,707,184,57,462,891
Santa Fe39,159,145,2,1,8,0,1,17,380,128,29,304,508
Santa Fe4,25,19,0,0,0,0,1,4,49,16,5,44,65
Santa Fe40,43,41,2,1,3,1,1,11,159,30,19,84,189
Santa Fe41,51,79,0,0,1,0,0,5,224,33,6,130,257
Santa Fe42,104,163,2,0,0,0,3,5,420,53,10,267,473
Santa Fe43,104,153,1,0,2,0,4,12,379,52,19,257,431
Santa Fe44,209,238,1,2,1,0,3,13,626,51,20,447,677
Santa Fe45,116,109,1,0,1,1,6,15,312,64,24,225,376
Santa Fe46,95,64,2,0,2,0,7,11,296,51,22,159,347
Santa Fe47,225,176,4,0,0,0,8,8,656,78,20,401,734
Santa Fe48,376,324,2,1,2,1,7,36,1103,178,49,700,1281
Santa Fe49,170,161,1,1,6,2,4,9,418,114,23,331,532
Santa Fe5,185,139,3,1,11,1,5,15,430,140,36,324,570
Santa Fe50,178,182,1,3,7,1,1,24,535,99,37,360,634
Santa Fe51,160,146,2,3,8,0,5,25,470,102,43,306,572
Santa Fe52,204,287,2,3,9,1,6,33,776,178,54,491,954
Santa Fe53,212,247,0,1,6,2,10,28,717,166,47,459,883
Santa Fe54,271,227,8,0,2,0,8,22,811,172,40,498,983
Santa Fe55,382,277,2,0,4,1,14,37,1063,169,58,659,1232
Santa Fe56,190,203,5,0,9,2,6,44,626,231,66,393,857
Santa Fe57,111,137,2,3,8,1,0,21,367,121,35,248,488
Santa Fe58,141,75,1,1,11,0,8,18,340,127,39,216,467
Santa Fe59,145,133,2,0,8,1,7,23,395,150,41,278,545
Santa Fe6,31,22,0,1,0,0,1,1,100,3,3,53,103
Santa Fe60,50,39,2,3,4,1,3,14,132,76,27,89,208
Santa Fe61,201,176,1,1,4,0,4,25,560,151,35,377,711
Santa Fe62,160,141,1,1,6,0,2,12,554,135,22,301,689
Santa Fe63,154,163,1,1,0,0,1,31,519,134,34,317,653
Santa Fe64,166,183,3,2,15,1,5,26,649,162,52,349,811
Santa Fe65,404,390,2,6,7,2,13,76,1291,264,106,794,1555
Santa Fe66,191,212,2,1,10,1,8,39,769,204,61,403,973
Santa Fe67,256,271,1,0,6,0,7,34,929,230,48,527,1159
Santa Fe68,161,185,0,0,1,0,4,27,628,128,32,346,756
Santa Fe69,464,395,5,2,12,3,22,61,1274,250,105,859,1524
Santa Fe7,77,93,0,2,4,0,4,18,286,64,28,170,350
Santa Fe70,480,424,7,2,16,5,21,106,1553,480,157,904,2033
Santa Fe71,340,284,3,0,10,2,15,52,975,245,82,624,1220
Santa Fe72,176,325,2,0,6,1,7,27,751,140,43,501,891
Santa Fe73,68,77,2,6,50,3,15,174,309,618,250,145,927
Santa Fe74,154,149,2,2,3,0,2,16,475,79,25,303,554
Santa Fe75,149,212,4,3,7,1,5,19,704,166,39,361,870
Santa Fe76,174,168,3,1,4,1,6,20,486,125,35,342,611
Santa Fe77,246,233,1,1,5,0,6,43,690,165,56,479,855
Santa Fe78,440,328,3,6,15,4,13,61,1262,289,102,768,1551
Santa Fe79,91,75,3,1,4,2,3,12,277,105,25,166,382
Santa Fe8,209,168,3,2,3,2,11,9,642,103,30,377,745
Santa Fe80,74,64,1,3,5,0,1,15,350,102,25,138,452
Santa Fe81,102,144,3,0,4,0,4,30,391,111,41,246,502
Santa Fe82,206,87,3,1,6,1,21,59,602,300,91,293,902
Santa Fe83,336,171,3,3,7,0,19,47,908,262,79,507,1170
Santa Fe84,50,91,2,10,30,2,14,166,303,668,224,141,971
Santa Fe85,46,82,1,8,26,1,10,112,246,598,158,128,844
Santa Fe86,246,299,8,4,17,1,2,47,950,269,79,545,1219
Santa Fe87,40,37,0,0,7,0,1,10,113,40,18,77,153
Santa Fe88,152,179,0,5,14,3,8,49,524,240,79,331,764
Santa Fe89,196,234,2,3,12,1,6,43,775,271,67,430,1046
Santa Fe9,237,167,3,0,2,0,14,33,677,153,52,404,830
Santa Fe90,376,277,5,1,7,2,25,69,1144,393,109,653,1537
Sierra1,53,62,1,3,8,2,7,100,220,327,121,115,547
Sierra2,84,87,7,9,25,2,23,350,291,939,416,171,1230
Sierra3,6,14,1,1,7,0,2,69,39,175,80,20,214
Sierra4,13,26,0,3,5,0,2,60,56,150,70,39,206
Sierra5,50,72,3,6,13,0,5,143,217,462,170,122,679
Sierra6,14,54,0,1,3,0,0,14,121,51,18,68,172
Sierra7,38,74,3,0,3,1,4,70,187,241,81,112,428
Sierra8,58,57,6,1,8,0,6,62,202,217,83,115,419
Sierra9,85,86,6,8,22,0,8,145,279,448,189,171,727
Socorro1,73,81,4,4,10,1,1,31,241,119,51,154,360
Socorro10,16,16,2,0,3,0,1,6,48,23,12,32,71
Socorro11,51,66,3,9,25,0,9,82,159,259,128,117,418
Socorro12,1,1,0,1,0,0,0,4,2,14,5,2,16
Socorro13,31,49,3,4,14,2,8,75,146,202,106,80,348
Socorro14,24,33,3,4,6,3,9,50,90,169,75,57,259
Socorro15,169,101,6,6,7,1,1,12,467,83,33,270,550
Socorro16,0,0,0,0,0,0,0,8,3,16,8,0,19
Socorro17,16,7,0,0,1,1,0,12,35,29,14,23,64
Socorro18,73,90,1,0,10,1,5,35,239,153,52,163,392
Socorro19,48,43,4,7,10,0,4,62,125,196,87,91,321
Socorro2,74,66,5,2,12,1,11,32,262,127,63,140,389
Socorro20,29,26,1,0,8,0,1,32,111,84,42,55,195
Socorro21,1,0,0,0,0,0,0,2,4,3,2,1,7
Socorro22,1,12,0,0,2,0,2,15,14,43,19,13,57
Socorro23,18,18,0,1,3,0,1,13,53,44,18,36,97
Socorro24,25,36,2,3,8,0,3,32,82,120,48,61,202
Socorro25,19,11,0,0,1,0,0,6,49,34,7,30,83
Socorro26,0,1,0,0,0,0,0,2,2,5,2,1,7
Socorro27,30,36,3,1,18,1,1,40,139,225,64,66,364
Socorro3,87,121,3,5,13,2,12,39,330,177,74,208,507
Socorro4,28,39,0,1,3,0,4,14,88,65,22,67,153
Socorro5,46,39,2,1,5,1,1,35,120,77,45,85,197
Socorro6,61,40,3,2,11,0,7,33,140,105,56,101,245
Socorro7,19,9,1,0,0,0,0,2,53,12,3,28,65
Socorro8,112,83,4,2,13,1,9,62,298,203,91,195,501
Socorro9,3,3,0,0,1,0,2,17,13,29,20,6,42
Taos1,28,134,1,0,6,0,1,12,215,54,20,162,269
Taos10,60,116,0,0,3,0,3,3,247,49,9,176,296
Taos11,166,224,0,0,6,1,1,18,582,79,26,390,661
Taos12,218,318,3,1,6,1,5,29,778,156,45,536,934
Taos13,78,75,2,1,2,0,1,0,408,16,6,153,424
Taos14,79,133,1,1,6,1,2,14,292,88,25,212,380
Taos15,205,350,3,0,5,1,7,25,747,158,41,555,905
Taos16,98,165,0,1,0,0,5,8,347,63,14,263,410
Taos17,240,408,2,1,4,3,5,43,960,204,58,648,1164
Taos18,159,272,0,2,6,1,4,28,553,161,41,431,714
Taos19,243,278,3,1,6,1,3,21,659,182,35,521,841
Taos2,44,13,0,0,1,0,0,1,91,23,2,57,114
Taos20,131,127,3,0,3,0,0,13,328,83,19,258,411
Taos21,191,175,1,0,6,0,1,29,489,137,37,366,626
Taos22,31,66,0,0,0,0,0,12,118,30,12,97,148
Taos23,10,35,0,1,0,0,0,2,44,13,3,45,57
Taos24,53,31,1,0,4,0,0,8,92,33,13,84,125
Taos25,21,21,3,0,5,2,3,12,83,41,25,42,124
Taos26,15,12,0,1,6,0,0,3,36,19,10,27,55
Taos27,77,44,1,2,5,0,0,7,158,47,15,121,205
Taos28,82,67,2,0,9,0,1,10,155,67,22,149,222
Taos29,36,27,1,0,1,0,1,8,85,28,11,63,113
Taos3,22,27,0,0,1,0,0,12,54,27,13,49,81
Taos30,17,8,0,0,1,0,0,2,34,4,3,25,38
Taos31,8,8,0,0,1,0,0,0,20,11,1,16,31
Taos32,49,32,2,1,2,0,0,2,116,20,7,81,136
Taos33,10,13,0,0,0,0,1,2,48,16,3,23,64
Taos34,109,108,1,0,1,1,4,27,317,97,34,217,414
Taos35,167,250,1,1,7,0,3,18,560,145,30,417,705
Taos36,16,12,0,0,0,0,0,0,42,4,0,28,46
Taos4,90,95,0,2,7,0,1,12,241,69,22,185,310
Taos5,74,82,1,0,5,2,0,8,208,68,16,156,276
Taos6,123,94,3,0,10,1,0,17,286,113,31,217,399
Taos7,15,30,1,1,3,0,5,25,93,208,35,45,301
Taos8,41,86,0,0,0,0,2,5,170,25,7,127,195
Taos9,297,424,0,1,7,2,11,24,1012,189,45,721,1201
Torrance1,69,53,5,2,23,1,4,75,149,283,110,122,432
Torrance10,34,57,0,2,22,0,8,53,99,183,85,91,282
Torrance11,19,3,1,1,5,1,2,16,26,43,26,22,69
Torrance12,1,6,0,2,4,1,0,13,4,53,20,7,57
Torrance13,84,66,5,6,24,1,3,132,222,465,171,150,687
Torrance14,1,3,1,0,5,0,0,20,4,53,26,4,57
Torrance15,11,19,0,0,9,0,1,33,63,149,43,30,212
Torrance16,54,44,0,0,12,1,2,64,125,171,79,98,296
Torrance2,16,24,2,0,13,2,4,44,45,159,65,40,204
Torrance3,35,23,4,4,13,1,1,43,69,107,66,58,176
Torrance4,32,26,2,3,11,1,0,29,62,73,46,58,135
Torrance5,71,111,6,4,27,5,13,180,342,750,235,182,1092
Torrance6,96,91,2,5,48,3,9,142,258,603,209,187,861
Torrance7,40,53,3,4,18,1,4,82,140,303,112,93,443
Torrance8,29,16,1,2,7,0,0,15,50,78,25,45,128
Torrance9,59,60,3,5,29,2,6,82,127,241,127,119,368
Union1,6,19,0,3,10,1,1,61,47,201,76,25,248
Union4,44,50,6,3,24,1,7,88,76,373,129,94,449
Union6,51,65,4,2,4,3,2,79,104,290,94,116,394
Union7,44,35,5,2,6,1,2,46,80,196,62,79,276
Union8,5,11,2,2,9,0,2,23,11,92,38,16,103
Union9,4,10,0,0,6,0,0,17,2,64,23,14,66
Valencia1,13,14,0,0,5,1,0,16,63,79,22,27,142
Valencia10,55,60,1,2,14,1,3,45,189,211,66,115,400
Valencia11,42,43,4,5,28,1,7,108,154,371,153,85,525
Valencia12,64,60,3,2,14,1,5,58,256,309,83,124,565
Valencia13,47,28,0,0,1,1,1,5,189,63,8,75,252
Valencia14,88,67,3,2,24,2,2,72,264,302,105,155,566
Valencia15,45,31,0,1,8,0,1,29,147,182,39,76,329
Valencia16,76,79,0,4,6,3,1,31,399,223,45,155,622
Valencia17,147,149,3,5,22,6,12,112,604,682,160,296,1286
Valencia18,41,62,2,3,16,5,14,86,189,337,126,103,526
Valencia19,40,31,4,1,14,2,3,72,137,262,96,71,399
Valencia2,126,111,3,5,12,1,6,57,381,370,84,237,751
Valencia20,25,19,2,0,6,0,0,30,75,131,38,44,206
Valencia21,127,98,5,5,14,0,4,88,394,423,116,225,817
Valencia22,32,33,2,0,6,0,4,42,131,191,54,65,322
Valencia23,130,108,2,6,10,0,3,54,364,413,75,238,777
Valencia24,6,15,0,0,0,0,0,1,106,24,1,21,130
Valencia25,45,29,4,0,9,0,0,17,125,110,30,74,235
Valencia26,64,50,4,1,4,1,3,26,178,127,39,114,305
Valencia27,108,82,6,4,23,0,3,72,359,401,108,190,760
Valencia28,56,63,0,2,21,1,5,68,358,311,97,119,669
Valencia29,141,96,9,10,12,4,12,132,392,526,179,237,918
Valencia3,62,52,1,1,10,0,6,39,192,218,57,114,410
Valencia30,129,139,1,2,19,1,7,139,407,528,169,268,935
Valencia31,112,105,1,4,19,1,5,72,303,428,102,217,731
Valencia32,116,77,4,5,14,1,6,68,324,395,98,193,719
Valencia33,29,21,0,0,5,0,1,16,104,127,22,50,231
Valencia34,36,52,2,2,9,1,2,29,97,136,45,88,233
Valencia35,51,47,5,0,8,0,4,26,136,205,43,98,341
Valencia36,28,39,2,1,7,0,2,22,107,143,34,67,250
Valencia37,31,44,1,1,9,1,6,39,135,187,57,75,322
Valencia38,58,59,4,5,13,2,3,43,221,306,70,117,527
Valencia39,137,108,0,3,19,1,10,113,518,652,146,245,1170
Valencia4,67,67,3,8,19,2,10,105,198,395,147,134,593
Valencia40,94,92,5,3,23,2,9,77,335,387,119,186,722
Valencia41,109,92,1,1,25,0,12,86,379,495,125,201,874
Valencia5,111,111,6,5,26,1,7,127,360,502,172,222,862
Valencia6,105,111,3,4,24,4,10,87,404,472,132,216,876
Valencia7,142,123,5,5,26,3,10,132,483,591,181,265,1074
Valencia8,130,144,5,9,32,3,12,106,507,716,167,274,1223
Valencia9,62,74,3,4,15,1,8,71,177,284,102,136,461
