precinct,pri_dem_CLINTON,pri_dem_SANDERS,pri_rep_CARSON,pri_rep_CRUZ,pri_rep_KASICH,pri_rep_TRUMP,gen_dem_CLINTON,gen_rep_TRUMP,rep_primary_total,dem_primary_total,general_total
Adams111,11,6,2,6,2,45,24,109,55,17,133
Adams112,14,10,2,6,1,41,26,96,50,24,122
Adams113,17,11,8,8,2,59,56,117,77,28,173
Adams114,16,19,1,10,13,44,54,113,68,35,167
Adams115,18,11,4,5,11,53,48,123,73,29,171
Adams121,5,11,8,3,6,76,19,132,93,16,151
Adams122,9,7,3,11,6,55,16,137,75,16,153
Adams123,2,6,5,4,0,34,10,96,43,8,106
Adams211,3,2,0,3,0,14,4,29,17,5,33
Adams212,6,9,0,4,4,51,14,78,59,15,92
Adams221,0,0,2,2,5,27,3,63,36,0,66
Adams222,0,0,3,3,1,15,4,34,22,0,38
Adams311,17,20,0,0,0,0,46,176,0,37,222
Adams313,0,0,0,0,0,0,2,25,0,0,27
Adams321,3,4,2,4,1,32,15,54,39,7,69
Adams322,2,2,0,0,0,0,5,27,0,4,32
Adams323,0,0,2,4,0,17,6,43,23,0,49
Adams324,0,0,0,1,2,12,2,38,15,0,40
Adams325,0,0,0,0,0,0,6,8,0,0,14
Adams411,0,0,0,0,0,0,21,23,0,0,44
Adams412,28,37,10,11,2,55,143,124,78,65,267
Adams413,51,19,1,9,4,46,140,121,60,70,261
Adams414,26,21,3,16,7,53,93,163,79,47,256
Adams415,21,21,4,21,4,60,89,132,89,42,221
Adams416,28,17,3,3,2,29,99,124,37,45,223
Adams511,26,15,0,2,1,16,67,50,19,41,117
Adams512,17,12,2,8,2,49,59,116,61,29,175
Adams513,29,23,4,13,1,83,88,221,101,52,309
Adams514,17,9,1,18,4,60,66,170,83,26,236
Adams515,11,12,1,13,1,48,43,133,63,23,176
Adams516,5,10,4,5,5,88,31,208,102,15,239
Asotin1,7,18,4,13,2,71,32,153,90,25,185
Asotin101,41,29,6,7,0,73,91,157,86,70,248
Asotin102,24,28,3,2,8,73,73,185,86,52,258
Asotin201,31,40,8,4,3,58,110,131,73,71,241
Asotin202,47,58,6,16,12,67,144,179,101,105,323
Asotin203,46,39,3,12,11,55,136,152,81,85,288
Asotin204,38,40,8,5,2,94,123,208,109,78,331
Asotin205,36,30,2,10,8,47,102,130,67,66,232
Asotin206,45,43,8,14,7,82,137,177,111,88,314
Asotin207,41,27,4,7,3,55,103,126,69,68,229
Asotin208,47,39,3,6,6,70,118,194,85,86,312
Asotin3,17,14,3,7,9,84,37,163,103,31,200
Asotin301,40,36,5,8,15,128,132,272,156,76,404
Asotin302,70,52,9,19,15,196,189,415,239,122,604
Asotin303,21,8,1,6,1,43,42,99,51,29,141
Asotin304,53,33,5,15,9,87,116,212,116,86,328
Asotin305,60,65,17,23,7,215,181,486,262,125,667
Asotin306,86,55,18,11,16,171,199,365,216,141,564
Asotin307,58,47,13,18,6,126,137,278,163,105,415
Asotin4,14,9,6,5,4,82,35,182,97,23,217
Asotin401,41,48,1,2,9,112,105,213,124,89,318
Asotin402,66,54,7,7,8,99,152,261,121,120,413
Asotin5,75,38,8,17,24,167,186,315,216,113,501
Asotin501,66,36,5,15,13,85,151,215,118,102,366
Asotin502,51,36,4,19,2,76,142,203,101,87,345
Asotin503,70,59,5,16,11,133,161,270,165,129,431
Benton1020,0,0,0,0,0,0,0,0,0,0,0
Benton1021,0,0,0,0,0,0,0,0,0,0,0
Benton1022,0,0,0,2,1,10,5,32,13,0,37
Benton1023,2,5,1,7,0,12,12,37,20,7,49
Benton1060,0,0,0,0,0,0,0,0,0,0,0
Benton1061,0,0,0,0,0,0,0,0,0,0,0
Benton1090,0,0,0,0,0,0,0,0,0,0,0
Benton1091,4,5,0,0,0,0,15,67,0,9,82
Benton1240,8,2,0,0,0,0,11,22,0,10,33
Benton1241,0,0,3,1,0,12,2,22,16,0,24
Benton1290,5,5,2,2,0,32,22,75,36,10,97
Benton1291,0,0,0,0,0,0,0,0,0,0,0
Benton1292,0,0,0,0,0,0,0,0,0,0,0
Benton1360,0,0,0,6,0,17,3,43,23,0,46
Benton1362,0,0,0,0,0,0,0,0,0,0,0
Benton1363,0,0,0,0,0,0,0,0,0,0,0
Benton1364,0,0,0,0,0,0,0,0,0,0,0
Benton1365,0,0,3,6,3,26,13,64,38,0,77
Benton1400,0,0,0,2,1,8,5,23,11,0,28
Benton1402,19,14,3,10,0,76,56,168,89,33,224
Benton1403,0,0,0,0,0,0,0,0,0,0,0
Benton1404,3,2,0,3,2,21,21,46,26,5,67
Benton1406,21,31,13,25,5,82,96,225,125,52,321
Benton1407,0,0,0,0,0,0,0,0,0,0,0
Benton1408,0,0,0,0,0,0,2,9,0,0,11
Benton1409,0,0,1,5,1,24,16,76,31,0,92
Benton1412,21,16,3,12,3,65,72,193,83,37,265
Benton1413,0,0,0,0,0,0,0,0,0,0,0
Benton1414,7,8,1,5,4,13,23,72,23,15,95
Benton1420,9,14,3,18,6,107,65,267,134,23,332
Benton1422,5,6,2,0,0,21,26,51,23,11,77
Benton1645,22,22,1,0,2,32,77,74,35,44,151
Benton1646,9,23,3,4,1,31,106,146,39,32,252
Benton1650,45,46,3,14,7,132,191,341,156,91,532
Benton1651,11,13,1,5,0,27,56,83,33,24,139
Benton1655,23,16,2,8,3,47,81,156,60,39,237
Benton1656,15,25,2,5,2,54,128,149,63,40,277
Benton1657,27,17,1,3,3,68,94,187,75,44,281
Benton1660,38,37,8,16,6,102,165,293,132,75,458
Benton1663,25,31,4,12,13,79,119,270,108,56,389
Benton1664,62,53,9,19,25,131,284,428,184,115,712
Benton1665,53,43,11,31,22,147,238,484,211,96,722
Benton1667,21,33,3,8,5,52,66,104,68,54,170
Benton1668,70,55,18,24,17,164,246,431,223,125,677
Benton1669,34,29,1,6,6,73,130,220,86,63,350
Benton1670,20,35,12,21,14,61,128,258,108,55,386
Benton1674,13,24,6,7,7,84,109,208,104,37,317
Benton1675,11,9,3,11,4,39,50,126,57,20,176
Benton1676,66,32,15,22,12,165,187,359,214,98,546
Benton1680,30,39,14,25,12,109,138,339,160,69,477
Benton1681,40,28,6,16,12,77,162,236,111,68,398
Benton1682,59,40,5,36,19,136,177,413,196,99,590
Benton1683,47,22,4,10,16,107,143,258,137,69,401
Benton1685,34,57,3,12,14,118,180,329,147,91,509
Benton1686,47,25,6,15,12,91,146,255,124,72,401
Benton1690,69,46,2,22,24,155,246,415,203,115,661
Benton1691,6,3,2,7,0,26,34,95,35,9,129
Benton2401,52,40,11,29,5,155,165,427,200,92,592
Benton2403,40,40,3,21,11,85,170,264,120,80,434
Benton2404,19,14,5,10,9,83,79,233,107,33,312
Benton2405,39,43,0,25,9,114,130,297,148,82,427
Benton2406,35,16,3,15,4,73,108,189,95,51,297
Benton2407,5,4,0,1,3,10,18,27,14,9,45
Benton2408,17,7,0,2,1,23,63,55,26,24,118
Benton2409,0,0,0,0,0,0,0,0,0,0,0
Benton2560,27,35,2,11,3,48,124,159,64,62,283
Benton2565,32,28,1,3,3,40,126,137,47,60,263
Benton2570,23,38,9,10,7,73,117,220,99,61,337
Benton2574,19,27,5,0,6,42,74,144,53,46,218
Benton2575,16,20,1,5,0,45,71,121,51,36,192
Benton2580,35,17,4,4,9,53,101,138,70,52,239
Benton2585,17,25,4,5,10,56,81,155,75,42,236
Benton2590,36,23,2,8,5,68,161,198,83,59,359
Benton2595,25,32,9,16,5,77,112,222,107,57,334
Benton2600,27,17,5,9,5,57,98,164,76,44,262
Benton2601,11,31,2,8,2,58,99,151,70,42,250
Benton2605,22,25,4,12,6,72,95,215,94,47,310
Benton2610,39,36,5,8,6,60,116,160,79,75,276
Benton2615,22,12,0,3,5,36,63,89,44,34,152
Benton2620,21,11,4,8,4,71,94,207,87,32,301
Benton2625,48,58,3,10,9,99,226,259,121,106,485
Benton2626,19,28,1,8,5,52,109,177,66,47,286
Benton2630,20,39,2,16,8,89,123,244,115,59,367
Benton2632,0,0,0,0,0,0,0,0,0,0,0
Benton2633,34,17,6,17,9,109,138,233,141,51,371
Benton2634,60,31,6,12,27,145,170,325,190,91,495
Benton2635,32,38,7,17,7,136,163,371,167,70,534
Benton2636,27,27,5,17,16,106,118,332,144,54,450
Benton2637,53,17,6,21,15,101,165,315,143,70,480
Benton2638,17,43,6,25,13,123,152,340,167,60,492
Benton2639,26,18,1,5,2,78,72,178,86,44,250
Benton2640,30,30,10,24,7,102,127,321,143,60,448
Benton2641,35,25,4,17,13,80,143,215,114,60,358
Benton3001,46,66,8,19,3,132,175,365,162,112,540
Benton3002,37,35,5,9,7,114,127,300,135,72,427
Benton3003,0,0,0,0,0,0,0,0,0,0,0
Benton3101,31,23,6,17,6,87,98,239,116,54,337
Benton3102,40,60,10,31,10,170,160,490,221,100,650
Benton3103,0,0,0,0,0,0,0,0,0,0,0
Benton3104,0,0,0,0,0,0,5,7,0,0,12
Benton3105,0,0,0,0,2,4,5,21,6,0,26
Benton3106,22,19,3,12,2,99,61,269,116,41,330
Benton3107,34,35,6,13,8,147,116,325,174,69,441
Benton3500,8,17,0,3,0,16,46,47,19,25,93
Benton3505,34,33,1,4,4,65,160,179,74,67,339
Benton3510,17,27,1,4,0,45,112,134,50,44,246
Benton3511,4,2,0,3,0,4,16,15,7,6,31
Benton3515,31,24,6,4,1,53,125,133,64,55,258
Benton3516,2,4,0,0,0,0,12,18,0,6,30
Benton3520,15,22,0,4,0,28,102,97,32,37,199
Benton3525,28,37,1,11,6,58,142,167,76,65,309
Benton3530,52,53,2,7,2,46,211,137,57,105,348
Benton3535,20,25,6,5,3,43,75,129,57,45,204
Benton3540,40,31,11,23,3,78,168,241,115,71,409
Benton3545,16,19,0,5,3,48,71,146,56,35,217
Benton3550,23,31,3,21,3,111,106,274,138,54,380
Benton3551,31,23,5,14,9,80,139,270,108,54,409
Benton3552,16,28,6,13,9,87,150,287,115,44,437
Benton3553,32,32,3,13,5,83,131,283,104,64,414
Benton3555,29,23,5,14,6,87,105,206,112,52,311
Benton3556,36,30,5,13,10,137,154,367,165,66,521
Benton3557,22,27,14,30,4,98,104,312,146,49,416
Benton3558,47,35,1,38,7,124,140,388,170,82,528
Benton3559,29,34,7,17,2,130,147,379,156,63,526
Benton3560,20,14,7,12,3,51,61,150,73,34,211
Benton4001,18,32,3,6,4,48,101,126,61,50,227
Benton4002,20,25,5,5,5,50,76,161,65,45,237
Benton4003,13,20,2,3,4,53,55,158,62,33,213
Benton4004,36,48,7,24,14,143,192,378,188,84,570
Benton4005,16,17,1,7,1,52,64,128,61,33,192
Benton4006,33,32,8,21,10,105,179,341,144,65,520
Benton4007,39,46,4,12,17,107,155,317,140,85,472
Benton4008,55,41,8,30,12,113,176,301,163,96,477
Benton4009,27,34,2,15,8,73,124,209,98,61,333
Benton4010,0,0,0,3,1,9,22,29,13,0,51
Benton4011,24,26,3,11,7,109,124,353,130,50,477
Benton4012,34,57,8,40,5,114,183,423,167,91,606
Benton4013,16,16,5,10,3,83,72,233,101,32,305
Benton4014,65,47,12,32,25,189,285,527,258,112,812
Benton4015,28,28,3,16,4,90,111,256,113,56,367
Benton4016,12,20,7,9,8,67,69,179,91,32,248
Benton4017,25,12,0,19,9,67,76,213,95,37,289
Benton4101,13,20,0,21,10,68,85,192,99,33,277
Benton4102,33,38,7,17,15,121,157,344,160,71,501
Benton4103,16,28,4,31,6,107,99,286,148,44,385
Benton450,51,41,10,11,13,118,180,286,152,92,466
Benton455,44,41,5,10,9,72,153,209,96,85,362
Benton460,38,26,9,18,11,70,132,187,108,64,319
Benton465,42,35,6,9,18,98,182,239,131,77,421
Benton470,26,30,6,14,11,60,140,176,91,56,316
Benton5602,34,18,1,6,5,105,96,295,117,52,391
Benton5603,9,2,3,3,1,16,27,60,23,11,87
Benton5606,45,43,4,29,7,165,142,509,205,88,651
Benton5608,26,22,3,9,3,59,84,171,74,48,255
Benton5609,17,16,3,7,3,110,83,289,123,33,372
Benton5613,6,3,1,4,0,12,22,62,17,9,84
Benton5615,26,34,2,7,3,110,130,302,122,60,432
Benton5619,8,13,4,5,1,41,56,117,51,21,173
Benton5621,7,13,1,9,6,38,32,126,54,20,158
Benton5622,12,11,3,5,0,53,43,113,61,23,156
Benton5623,22,25,3,1,5,59,92,151,68,47,243
Benton5624,23,16,5,13,7,70,61,179,95,39,240
Benton5625,34,32,9,31,11,121,144,365,172,66,509
Benton5626,12,8,2,10,1,47,52,136,60,20,188
Benton5627,48,48,12,24,17,139,167,454,192,96,621
Benton5628,39,35,7,11,8,154,132,380,180,74,512
Benton5629,22,19,1,7,3,88,78,235,99,41,313
Benton5630,19,21,7,21,7,98,111,293,133,40,404
Benton5631,0,0,0,0,0,0,0,0,0,0,0
Benton5632,0,0,0,0,0,0,2,4,0,0,6
Benton5633,4,3,3,5,0,12,12,28,20,7,40
Benton5634,0,0,0,0,0,0,0,0,0,0,0
Benton5635,0,0,0,0,0,0,4,11,0,0,15
Benton5636,0,0,0,0,0,0,0,0,0,0,0
Benton5637,5,8,0,0,0,0,16,35,0,13,51
Benton5638,34,38,4,27,13,168,185,558,212,72,743
Benton5639,12,19,6,24,8,108,71,341,146,31,412
Benton6105,28,29,4,13,7,98,126,207,122,57,333
Benton6110,56,34,7,15,11,54,227,180,87,90,407
Benton6115,46,42,2,7,12,40,175,117,61,88,292
Benton6120,45,30,5,16,20,75,184,175,116,75,359
Benton6125,21,22,6,13,6,44,111,150,69,43,261
Benton6130,41,33,0,17,21,43,186,120,81,74,306
Benton6135,36,35,4,12,13,44,154,125,73,71,279
Benton6140,33,40,8,11,8,68,146,167,95,73,313
Benton6145,50,43,7,14,18,82,228,230,121,93,458
Benton6150,55,36,5,7,31,150,213,392,193,91,605
Benton6151,85,55,10,30,24,129,312,388,193,140,700
Benton6155,49,39,9,17,24,98,185,281,148,88,466
Benton6160,50,58,10,26,21,63,232,198,120,108,430
Benton6165,47,44,3,8,4,48,134,147,63,91,281
Benton6170,22,60,5,15,4,58,153,233,82,82,386
Benton6175,45,56,9,37,23,106,206,361,175,101,567
Benton6180,25,50,5,6,7,32,143,114,50,75,257
Benton6185,48,34,4,6,3,52,141,132,65,82,273
Benton6186,17,22,2,2,2,22,77,71,28,39,148
Benton6190,44,54,5,20,12,68,188,192,105,98,380
Benton6195,25,23,1,15,5,69,108,198,90,48,306
Benton6200,30,50,1,15,6,71,137,176,93,80,313
Benton6205,19,48,3,14,4,49,136,161,70,67,297
Benton6210,21,38,4,7,8,74,87,175,93,59,262
Benton6215,21,35,3,7,4,65,106,182,79,56,288
Benton6220,20,37,6,10,3,45,113,174,64,57,287
Benton6225,31,28,7,14,16,74,123,206,111,59,329
Benton6230,24,33,1,8,7,35,124,181,51,57,305
Benton6235,26,26,2,6,3,49,101,136,60,52,237
Benton6240,48,62,11,17,10,133,222,350,171,110,572
Benton6245,25,35,4,8,4,46,117,187,62,60,304
Benton6250,35,45,8,19,2,60,147,204,89,80,351
Benton6255,47,63,8,16,8,70,187,277,102,110,464
Benton6260,19,33,7,13,9,62,81,159,91,52,240
Benton6265,33,43,7,8,3,63,133,212,81,76,345
Benton6270,65,56,9,18,18,105,212,250,150,121,462
Benton6271,21,20,4,17,4,54,88,167,79,41,255
Benton6275,26,32,2,8,4,40,123,116,54,58,239
Benton6278,40,26,4,30,13,104,156,314,151,66,470
Benton6279,9,13,4,11,2,33,71,83,50,22,154
Benton6280,45,40,4,21,13,79,202,265,117,85,467
Benton6281,72,36,9,22,28,90,246,305,149,108,551
Benton6282,62,42,2,32,8,128,242,367,170,104,609
Benton6283,29,39,2,22,11,64,135,214,99,68,349
Benton6284,28,24,2,7,15,75,130,216,99,52,346
Benton6285,58,42,9,29,10,134,242,379,182,100,621
Benton6286,27,13,5,18,8,78,104,183,109,40,287
Benton6287,39,40,1,4,4,75,150,187,84,79,337
Benton6288,57,27,10,27,14,64,211,258,115,84,469
Benton6289,49,42,9,11,26,143,239,381,189,91,620
Benton6290,39,50,5,8,7,96,154,304,116,89,458
Benton6291,52,47,8,17,7,117,250,350,149,99,600
Benton6292,32,25,3,17,12,66,111,172,98,57,283
Benton6293,15,17,1,8,6,60,73,174,75,32,247
Benton6295,41,34,2,13,20,91,118,253,126,75,371
Benton6300,44,23,9,13,15,85,123,231,122,67,354
Benton6301,39,34,5,12,9,90,228,336,116,73,564
Benton6305,40,26,4,9,15,94,181,273,122,66,454
Benton6310,48,30,4,19,12,86,196,269,121,78,465
Benton6311,0,0,0,0,0,0,0,0,0,0,0
Benton6315,74,39,5,26,31,175,297,481,237,113,778
Benton6316,0,0,0,0,0,0,0,0,0,0,0
Benton6320,51,42,12,25,33,104,255,416,174,93,671
Benton96,0,0,0,0,0,0,0,0,0,0,0
Benton97,0,0,0,0,0,0,0,0,0,0,0
Benton98,0,0,0,0,0,0,0,0,0,0,0
Benton99,0,0,0,0,0,0,0,0,0,0,0
Chelan100,0,0,0,0,0,0,4,7,0,0,11
Chelan110,48,54,6,7,7,102,201,217,122,102,418
Chelan111,17,23,0,1,9,31,47,80,41,40,127
Chelan112,3,7,0,0,0,0,15,25,0,10,40
Chelan113,12,11,0,3,0,33,44,64,36,23,108
Chelan114,64,47,11,11,11,136,203,271,169,111,474
Chelan1149,3,2,1,0,5,14,18,26,20,5,44
Chelan115,24,8,0,3,5,13,46,28,21,32,74
Chelan1150,0,0,2,0,0,5,0,0,7,0,0
Chelan1151,0,0,0,0,0,0,4,7,0,0,11
Chelan1152,5,7,2,3,5,12,27,50,22,12,77
Chelan1153,3,4,0,2,2,8,11,15,12,7,26
Chelan116,19,14,4,5,7,51,86,90,67,33,176
Chelan120,35,41,5,17,11,115,159,310,148,76,469
Chelan121,29,37,5,18,5,110,143,253,138,66,396
Chelan122,27,25,4,13,11,52,101,107,80,52,208
Chelan123,0,0,0,0,0,0,15,34,0,0,49
Chelan124,7,3,2,1,2,27,24,56,32,10,80
Chelan125,118,93,7,36,28,143,354,368,214,211,722
Chelan126,19,27,2,3,0,20,76,39,25,46,115
Chelan127,7,23,2,7,2,43,88,101,54,30,189
Chelan128,4,10,4,2,5,23,39,52,34,14,91
Chelan129,43,32,1,9,16,70,158,150,96,75,308
Chelan1290,0,0,0,0,0,0,2,2,0,0,4
Chelan131,5,13,2,3,2,29,31,45,36,18,76
Chelan132,4,9,0,0,0,0,20,37,0,13,57
Chelan133,36,33,2,10,11,114,134,309,137,69,443
Chelan134,38,47,16,36,16,152,206,488,220,85,694
Chelan135,60,48,6,26,18,195,0,0,245,108,0
Chelan136,0,0,0,0,0,0,0,0,0,0,0
Chelan140,39,33,3,6,1,57,124,120,67,72,244
Chelan141,0,0,0,0,0,0,10,9,0,0,19
Chelan142,0,0,0,0,0,0,11,8,0,0,19
Chelan143,0,0,0,0,0,0,7,6,0,0,13
Chelan144,0,0,0,2,0,10,7,27,12,0,34
Chelan145,3,2,0,2,0,15,8,35,17,5,43
Chelan146,12,11,2,4,3,43,37,101,52,23,138
Chelan147,42,53,7,21,8,234,178,497,270,95,675
Chelan148,37,32,9,5,2,66,129,181,82,69,310
Chelan149,19,15,5,7,10,59,71,144,81,34,215
Chelan150,15,5,1,2,1,18,41,38,22,20,79
Chelan151,0,0,0,0,0,0,2,3,0,0,5
Chelan152,0,0,0,0,0,0,0,0,0,0,0
Chelan153,101,57,21,36,27,271,355,640,355,158,995
Chelan154,106,59,4,27,25,213,338,510,269,165,848
Chelan155,27,41,4,4,17,79,111,184,104,68,295
Chelan156,8,10,1,4,1,20,41,50,26,18,91
Chelan157,58,60,2,25,15,206,206,460,248,118,666
Chelan158,16,22,4,2,5,54,79,137,65,38,216
Chelan159,0,0,0,0,0,0,2,8,0,0,10
Chelan161,3,7,0,0,0,0,13,42,0,10,55
Chelan162,11,7,0,0,0,0,19,19,0,18,38
Chelan163,2,3,0,0,0,0,12,25,0,5,37
Chelan164,9,15,2,4,5,71,48,209,82,24,257
Chelan165,13,10,1,9,3,41,54,125,54,23,179
Chelan171,0,0,0,0,0,0,6,14,0,0,20
Chelan172,2,3,0,3,0,10,9,18,13,5,27
Chelan173,7,13,0,1,2,3,37,10,6,20,47
Chelan174,50,46,4,11,12,128,155,282,155,96,437
Chelan175,114,70,8,23,39,190,340,447,260,184,787
Chelan181,73,40,5,11,9,176,219,359,201,113,578
Chelan182,57,54,8,10,15,135,229,290,168,111,519
Chelan183,30,28,5,9,14,65,116,158,93,58,274
Chelan190,10,9,3,9,1,5,26,37,18,19,63
Chelan210,76,88,6,4,15,81,316,198,106,164,514
Chelan220,76,113,11,10,17,118,372,255,156,189,627
Chelan310,37,45,4,9,2,70,142,174,85,82,316
Chelan320,24,24,9,23,14,90,135,262,136,48,397
Chelan330,31,33,8,28,10,108,147,276,154,64,423
Chelan410,46,31,7,14,14,132,194,320,167,77,514
Chelan420,75,65,8,20,22,136,260,357,186,140,617
Chelan430,98,83,16,33,18,195,370,472,262,181,842
Chelan440,112,67,15,30,28,209,400,485,282,179,885
Chelan450,112,84,10,26,27,163,401,467,226,196,868
Chelan460,114,119,13,20,16,168,506,393,217,233,899
Chelan470,99,85,10,24,30,134,348,366,198,184,714
Chelan480,102,131,9,29,20,154,502,445,212,233,947
Chelan490,52,58,2,13,10,105,181,270,130,110,451
Chelan510,76,84,7,20,6,134,315,326,167,160,641
Chelan520,118,69,15,33,58,276,416,624,382,187,1040
Chelan530,109,92,12,23,21,228,374,521,284,201,895
Chelan540,84,71,6,19,17,189,289,417,231,155,706
Chelan560,105,118,7,33,13,165,499,480,218,223,979
Chelan580,53,45,7,16,12,143,194,298,178,98,492
Chelan590,88,56,15,16,26,181,267,408,238,144,675
Chelan610,53,42,10,12,8,146,142,342,176,95,484
Chelan710,55,50,12,9,10,113,210,244,144,105,454
Chelan720,80,53,13,17,22,199,233,383,251,133,616
Chelan730,82,102,13,7,16,134,340,360,170,184,700
Clallam101,74,74,7,7,13,94,245,242,121,148,487
Clallam102,121,139,0,15,11,122,494,322,148,260,816
Clallam103,126,140,11,14,24,151,469,400,200,266,869
Clallam104,82,104,12,11,16,86,338,251,125,186,589
Clallam105,100,153,8,9,13,117,413,278,147,253,691
Clallam106,83,96,7,12,16,117,316,287,152,179,603
Clallam107,139,178,9,20,12,119,475,340,160,317,815
Clallam108,61,84,9,4,6,71,251,194,90,145,445
Clallam109,133,164,7,17,9,155,486,475,188,297,961
Clallam110,28,35,3,4,0,45,90,107,52,63,197
Clallam111,170,158,7,20,16,153,469,400,196,328,869
Clallam112,61,54,6,17,14,92,222,229,129,115,451
Clallam113,64,75,7,10,21,119,264,278,157,139,542
Clallam201,91,52,7,17,10,139,251,306,173,143,557
Clallam204,33,47,3,9,8,143,122,332,163,80,454
Clallam205,92,75,6,13,9,141,265,417,169,167,682
Clallam207,114,52,9,19,33,201,292,332,262,166,624
Clallam208,51,53,4,22,12,78,177,207,116,104,384
Clallam209,85,142,9,22,7,170,335,427,208,227,762
Clallam210,43,56,2,13,6,95,163,242,116,99,405
Clallam211,79,88,2,11,15,142,270,316,170,167,586
Clallam212,15,27,3,6,4,86,66,202,99,42,268
Clallam214,98,89,8,19,10,137,262,306,174,187,568
Clallam215,40,54,5,3,2,79,138,185,89,94,323
Clallam216,39,49,4,9,3,54,139,148,70,88,287
Clallam217,140,106,10,26,11,129,394,261,176,246,655
Clallam218,145,123,11,15,13,184,384,351,223,268,735
Clallam220,89,103,8,31,15,128,292,386,182,192,678
Clallam221,111,100,7,13,10,157,297,321,187,211,618
Clallam222,136,103,3,16,26,187,350,351,232,239,701
Clallam223,82,47,1,8,11,89,192,182,109,129,374
Clallam224,76,66,5,11,7,116,281,297,139,142,578
Clallam226,63,75,16,7,20,140,248,279,183,138,527
Clallam229,24,29,0,4,7,26,79,73,37,53,152
Clallam230,19,26,1,1,3,43,91,139,48,45,230
Clallam232,91,102,6,17,15,183,304,423,221,193,727
Clallam233,104,112,5,39,14,186,373,477,244,216,850
Clallam237,53,58,7,16,7,97,175,220,127,111,395
Clallam240,87,88,5,12,12,90,258,195,119,175,453
Clallam241,92,114,12,21,9,188,307,423,230,206,730
Clallam245,43,68,5,9,12,109,172,261,135,111,433
Clallam246,58,88,4,11,7,67,201,150,89,146,351
Clallam247,115,90,12,29,14,162,302,372,217,205,674
Clallam248,19,33,2,4,2,64,107,140,72,52,247
Clallam249,104,86,7,30,9,182,302,340,228,190,642
Clallam250,45,49,1,3,10,71,175,177,85,94,352
Clallam251,91,71,4,18,14,153,257,331,189,162,588
Clallam252,53,61,3,3,3,20,295,68,29,114,363
Clallam253,62,63,5,22,15,160,222,358,202,125,580
Clallam254,81,58,14,14,11,111,220,245,150,139,465
Clallam258,70,65,6,12,10,98,194,184,126,135,378
Clallam259,101,91,16,24,20,143,291,361,203,192,652
Clallam260,105,115,14,19,15,141,319,369,189,220,688
Clallam262,23,31,2,4,1,57,131,115,64,54,246
Clallam265,116,95,6,22,17,140,340,303,185,211,643
Clallam266,79,97,8,24,12,135,250,320,179,176,570
Clallam269,11,18,3,3,0,73,55,156,79,29,211
Clallam270,158,65,8,19,43,185,317,344,255,223,661
Clallam271,72,54,4,18,11,108,199,212,141,126,411
Clallam301,45,45,6,15,8,102,132,243,131,90,375
Clallam302,46,71,5,24,10,132,179,367,171,117,546
Clallam401,59,79,16,3,8,72,219,191,99,138,410
Clallam402,70,96,6,11,10,87,285,223,114,166,508
Clallam403,141,98,8,18,17,187,371,349,230,239,720
Clallam404,191,151,15,28,27,225,476,459,295,342,935
Clallam405,103,93,16,27,22,135,312,280,200,196,592
Clallam406,142,74,12,20,36,148,317,275,216,216,592
Clark100,189,246,1,21,17,88,746,251,127,435,997
Clark102,126,116,6,11,18,92,399,226,127,242,625
Clark104,158,133,8,14,15,123,526,295,160,291,821
Clark106,134,193,3,8,14,81,612,236,106,327,848
Clark108,140,200,5,6,14,80,665,229,105,340,894
Clark110,160,242,7,14,18,85,725,238,124,402,963
Clark112,16,10,1,2,0,14,64,31,17,26,95
Clark113,66,107,1,5,1,83,356,236,90,173,592
Clark120,215,219,11,15,26,135,781,339,187,434,1120
Clark130,168,232,10,13,16,90,736,243,129,400,979
Clark147,89,125,8,20,10,133,357,323,171,214,680
Clark150,91,160,0,8,5,79,429,193,92,251,622
Clark153,89,92,6,18,10,112,378,316,146,181,694
Clark160,88,186,6,3,12,90,515,251,111,274,766
Clark170,111,214,6,8,12,85,552,269,111,325,821
Clark175,85,180,6,18,8,115,498,321,147,265,819
Clark180,120,161,3,22,9,84,524,290,118,281,814
Clark190,164,217,10,11,20,132,663,329,173,381,992
Clark200,154,188,5,14,9,128,693,306,156,342,999
Clark220,101,161,2,22,10,82,425,257,116,262,682
Clark225,218,154,6,16,36,187,627,406,245,372,1033
Clark240,198,90,9,18,40,223,554,434,290,288,988
Clark245,122,129,9,16,34,168,446,410,227,251,856
Clark250,162,205,7,23,24,143,610,410,197,367,1020
Clark255,141,126,6,26,12,122,430,361,166,267,791
Clark257,152,198,12,11,17,146,581,385,186,350,966
Clark290,147,144,8,15,29,183,555,431,235,291,986
Clark294,87,106,6,20,19,124,393,326,169,193,719
Clark296,120,106,5,14,20,132,392,314,171,226,706
Clark298,125,63,5,17,8,101,285,216,131,188,501
Clark325,106,107,5,13,25,92,396,261,135,213,657
Clark327,112,111,12,23,13,191,441,447,239,223,888
Clark330,139,125,2,22,11,181,493,461,216,264,954
Clark335,105,144,5,13,11,114,442,375,143,249,817
Clark337,117,128,6,16,13,142,438,369,177,245,807
Clark338,111,133,2,23,15,167,463,445,207,244,908
Clark340,124,165,8,20,11,150,486,390,189,289,876
Clark350,105,106,7,17,12,140,368,321,176,211,689
Clark360,137,133,14,30,24,172,524,423,240,270,947
Clark370,106,131,7,17,14,138,440,341,176,237,781
Clark390,155,180,16,22,19,171,560,444,228,335,1004
Clark391,52,25,0,4,4,35,138,93,43,77,231
Clark395,47,58,1,5,2,33,204,103,41,105,307
Clark400,91,98,5,6,11,64,318,186,86,189,504
Clark410,145,177,3,16,16,155,529,354,190,322,883
Clark415,121,107,3,25,7,134,385,309,169,228,694
Clark420,142,118,5,14,15,159,482,381,193,260,863
Clark423,113,108,10,27,13,103,428,310,153,221,738
Clark424,164,138,4,29,29,165,478,435,227,302,913
Clark425,87,99,4,24,13,113,354,311,154,186,665
Clark426,141,138,6,13,26,185,528,472,230,279,1000
Clark430,87,105,6,13,6,100,381,257,125,192,638
Clark432,108,90,4,12,17,114,381,294,147,198,675
Clark434,129,74,5,10,27,136,378,350,178,203,728
Clark435,90,68,7,10,23,118,271,287,158,158,558
Clark436,76,78,2,10,15,111,308,263,138,154,571
Clark440,131,127,8,16,19,154,480,393,197,258,873
Clark441,107,124,8,29,26,148,492,451,211,231,943
Clark444,187,177,13,24,35,175,625,466,247,364,1091
Clark445,142,128,8,27,27,183,545,514,245,270,1059
Clark446,139,98,7,27,33,179,459,474,246,237,933
Clark447,179,146,7,34,35,177,627,526,253,325,1153
Clark448,147,132,8,24,33,178,567,445,243,279,1012
Clark449,185,144,13,21,37,177,610,451,248,329,1061
Clark450,188,138,4,37,42,194,683,507,277,326,1190
Clark451,120,120,4,12,26,136,452,377,178,240,829
Clark452,132,113,6,13,22,117,440,313,158,245,753
Clark453,102,119,5,11,29,142,405,376,187,221,781
Clark455,78,91,5,17,11,115,318,330,148,169,648
Clark456,171,167,11,26,33,235,623,557,305,338,1180
Clark460,174,140,5,21,25,211,551,485,262,314,1036
Clark470,195,139,6,15,37,180,606,386,238,334,992
Clark480,146,158,12,30,36,247,483,585,325,304,1068
Clark483,212,134,6,21,59,248,614,555,334,346,1169
Clark485,61,59,3,20,9,159,222,460,191,120,682
Clark487,43,41,4,15,11,91,198,277,121,84,475
Clark490,68,73,11,23,10,156,288,392,200,141,680
Clark491,6,5,0,0,3,14,26,35,17,11,61
Clark500,126,166,9,36,19,219,545,556,283,292,1101
Clark502,102,126,4,19,33,174,453,515,230,228,968
Clark503,92,96,11,23,17,177,426,602,228,188,1028
Clark505,105,114,12,35,25,237,401,592,309,219,993
Clark510,59,65,6,25,15,171,212,438,217,124,650
Clark511,9,2,0,1,2,21,13,29,24,11,42
Clark515,114,130,17,29,32,236,418,633,314,244,1051
Clark520,64,70,0,0,0,0,196,333,0,134,529
Clark521,2,2,0,0,0,0,9,11,0,4,20
Clark522,35,41,8,13,11,69,139,199,101,76,338
Clark523,0,0,0,3,0,12,6,24,15,0,30
Clark524,22,9,0,3,7,17,57,60,27,31,117
Clark525,69,60,7,17,11,138,215,374,173,129,589
Clark527,73,86,6,25,21,209,263,484,261,159,747
Clark528,72,91,16,40,13,234,268,629,303,163,897
Clark530,31,46,7,12,9,113,118,286,141,77,404
Clark535,118,116,16,57,26,279,351,803,378,234,1154
Clark536,38,56,5,25,7,137,146,417,174,94,563
Clark537,32,42,6,21,8,91,87,265,126,74,352
Clark538,23,40,3,14,11,135,104,355,163,63,459
Clark540,95,91,17,46,21,233,344,656,317,186,1000
Clark543,79,83,6,33,27,197,317,551,263,162,868
Clark545,67,68,5,22,14,140,217,421,181,135,638
Clark550,123,121,12,39,24,224,470,585,299,244,1055
Clark553,134,84,10,22,37,118,333,322,187,218,655
Clark555,138,125,5,23,22,209,442,553,259,263,995
Clark560,107,86,6,25,34,183,416,467,248,193,883
Clark563,95,145,9,18,32,176,446,513,235,240,959
Clark565,79,127,2,15,22,131,383,377,170,206,760
Clark566,78,78,4,13,16,150,275,354,183,156,629
Clark568,34,41,6,14,9,69,160,215,98,75,375
Clark569,74,84,7,18,13,103,318,398,141,158,716
Clark570,88,111,8,23,11,186,303,513,228,199,816
Clark571,92,90,9,21,14,186,387,538,230,182,925
Clark572,75,52,7,25,12,139,228,354,183,127,582
Clark573,143,110,17,16,29,204,513,617,266,253,1130
Clark574,7,5,0,0,4,12,19,21,16,12,40
Clark575,21,25,3,4,7,74,78,178,88,46,256
Clark576,0,0,0,0,2,2,2,4,4,0,6
Clark577,106,107,19,51,23,270,377,752,363,213,1129
Clark578,11,8,2,5,4,17,40,41,28,19,81
Clark579,7,8,1,0,2,5,22,18,8,15,40
Clark580,76,68,3,7,10,153,219,339,173,144,558
Clark581,35,55,4,16,13,77,186,292,110,90,478
Clark582,62,80,8,29,17,192,290,551,246,142,841
Clark583,59,92,10,27,7,131,308,488,175,151,796
Clark584,87,90,8,38,13,192,280,530,251,177,810
Clark585,100,66,3,27,21,234,342,553,285,166,895
Clark586,89,110,5,31,6,163,362,551,205,199,913
Clark587,81,90,23,31,9,155,261,559,218,171,820
Clark588,39,61,7,22,7,110,192,363,146,100,555
Clark589,24,46,4,8,6,70,132,204,88,70,336
Clark590,97,155,11,19,32,261,379,708,323,252,1087
Clark591,117,131,11,33,22,288,426,779,354,248,1205
Clark592,91,181,10,44,21,252,405,651,327,272,1056
Clark593,116,83,6,36,19,215,318,572,276,199,890
Clark594,2,12,0,2,0,17,16,32,19,14,48
Clark595,42,50,7,30,11,127,139,367,175,92,506
Clark597,4,9,0,7,4,39,22,76,50,13,98
Clark598,0,0,0,0,2,5,5,17,7,0,22
Clark600,24,36,9,16,7,132,120,400,164,60,520
Clark603,37,32,1,35,6,163,109,469,205,69,578
Clark605,51,72,9,26,16,259,173,657,310,123,830
Clark606,13,13,5,3,1,43,38,124,52,26,162
Clark610,95,150,22,44,32,228,424,699,326,245,1123
Clark613,30,35,7,28,6,102,139,240,143,65,379
Clark615,37,33,2,11,5,78,135,245,96,70,380
Clark617,93,111,11,27,29,218,366,554,285,204,920
Clark618,90,109,12,21,28,198,347,547,259,199,894
Clark620,96,96,6,39,23,225,331,641,293,192,972
Clark624,16,38,1,15,1,42,114,159,59,54,273
Clark625,97,95,13,40,13,228,351,581,294,192,932
Clark626,95,120,4,23,15,152,422,467,194,215,889
Clark627,90,118,14,24,19,173,377,505,230,208,882
Clark628,90,137,5,19,20,159,407,509,203,227,916
Clark629,71,110,8,33,15,165,431,508,221,181,939
Clark630,84,115,6,10,17,154,356,391,187,199,747
Clark631,193,163,4,15,25,146,688,373,190,356,1061
Clark632,58,57,5,12,5,64,243,274,86,115,517
Clark633,102,124,9,10,10,147,395,424,176,226,819
Clark634,83,129,7,24,10,126,409,441,167,212,850
Clark635,70,116,1,20,9,108,295,317,138,186,612
Clark636,86,110,0,30,18,147,362,456,195,196,818
Clark638,105,92,2,19,16,146,345,389,183,197,734
Clark639,110,123,13,15,10,140,401,387,178,233,788
Clark640,121,125,1,24,10,169,452,442,204,246,894
Clark641,64,79,1,11,15,60,305,214,87,143,519
Clark642,57,21,5,11,9,91,144,190,116,78,334
Clark643,104,120,6,12,13,176,415,482,207,224,897
Clark644,153,149,11,16,18,137,642,399,182,302,1041
Clark645,155,120,12,26,28,167,611,456,233,275,1067
Clark646,56,55,2,24,6,76,227,219,108,111,446
Clark647,87,44,4,8,15,116,343,317,143,131,660
Clark648,146,111,11,17,34,142,544,369,204,257,913
Clark649,82,104,9,21,11,151,364,417,192,186,781
Clark650,128,131,9,17,17,132,455,343,175,259,798
Clark651,89,88,8,27,14,127,343,326,176,177,669
Clark652,76,106,5,12,7,87,360,279,111,182,639
Clark653,100,151,4,18,11,133,462,360,166,251,822
Clark654,69,84,10,12,6,108,296,338,136,153,634
Clark655,116,101,3,15,13,143,368,306,174,217,674
Clark656,57,63,6,12,13,72,238,236,103,120,474
Clark657,51,46,4,3,9,55,207,170,71,97,377
Clark658,131,124,6,18,26,161,421,425,211,255,846
Clark659,87,173,8,22,8,162,461,439,200,260,900
Clark660,158,139,7,18,12,146,501,373,183,297,874
Clark662,102,147,9,23,18,173,450,418,223,249,868
Clark663,104,97,6,19,13,124,383,299,162,201,682
Clark664,140,131,3,24,25,153,549,433,205,271,982
Clark667,145,48,5,17,43,153,270,251,218,193,521
Clark668,190,75,6,15,46,162,363,276,229,265,639
Clark669,106,55,2,15,33,189,323,377,239,161,700
Clark670,161,179,3,24,22,160,610,425,209,340,1035
Clark672,101,140,3,19,13,129,432,325,164,241,757
Clark673,154,175,5,25,25,172,623,442,227,329,1065
Clark674,104,106,5,24,15,119,424,300,163,210,724
Clark675,98,68,5,10,33,103,318,263,151,166,581
Clark677,135,102,8,16,30,156,481,370,210,237,851
Clark678,114,116,7,27,27,104,416,288,165,230,704
Clark679,96,100,4,9,12,74,414,240,99,196,654
Clark680,126,102,4,18,25,120,440,310,167,228,750
Clark681,97,139,2,24,11,146,469,355,183,236,824
Clark682,118,134,2,19,14,122,493,307,157,252,800
Clark683,114,139,6,20,14,133,442,363,173,253,805
Clark685,34,35,0,3,5,37,140,130,45,69,270
Clark686,80,142,4,28,15,123,440,385,170,222,825
Clark687,109,116,11,16,18,150,398,389,195,225,787
Clark688,101,122,9,20,17,121,437,398,167,223,835
Clark689,100,135,5,33,10,157,425,495,205,235,920
Clark690,169,133,12,21,35,138,639,397,206,302,1036
Clark691,114,122,12,22,12,136,478,473,182,236,951
Clark692,150,149,11,31,33,199,523,552,274,299,1075
Clark693,52,78,8,17,13,94,235,279,132,130,514
Clark694,76,61,1,5,7,56,199,117,69,137,316
Clark695,135,114,6,19,23,151,445,389,199,249,834
Clark696,178,119,5,23,38,195,603,487,261,297,1090
Clark697,153,163,8,18,16,198,551,492,240,316,1043
Clark698,95,105,13,26,33,144,383,448,216,200,831
Clark699,95,102,5,16,23,128,495,446,172,197,941
Clark700,18,13,2,5,7,28,54,61,42,31,115
Clark710,68,96,8,8,8,70,347,264,94,164,611
Clark720,86,81,4,20,17,112,320,346,153,167,666
Clark900,75,101,4,26,16,173,382,488,219,176,870
Clark903,109,135,6,26,16,174,373,494,222,244,867
Clark905,148,98,9,17,27,189,603,568,242,246,1171
Clark910,110,144,7,23,10,183,388,473,223,254,861
Clark912,112,99,2,19,19,144,334,395,184,211,729
Clark913,135,119,10,26,19,227,470,570,282,254,1040
Clark914,76,105,11,25,18,169,366,539,223,181,905
Clark917,59,75,8,9,13,132,225,350,162,134,575
Clark920,77,88,4,14,12,175,277,408,205,165,685
Clark925,58,88,8,24,27,155,267,430,214,146,697
Clark930,85,129,8,29,26,173,377,465,236,214,842
Clark935,99,96,7,26,16,226,352,535,275,195,887
Clark940,94,100,8,28,24,178,332,492,238,194,824
Clark947,82,87,4,16,20,144,290,344,184,169,634
Clark950,110,141,3,23,10,138,468,430,174,251,898
Clark951,109,118,8,11,15,118,469,319,152,227,788
Clark953,69,57,2,6,6,51,302,204,65,126,506
Clark956,59,43,4,11,11,46,222,172,72,102,394
Clark957,31,11,4,5,11,26,117,111,46,42,228
Clark958,15,19,1,8,0,27,110,88,36,34,198
Clark959,2,5,0,2,1,13,12,28,16,7,40
Clark960,104,79,4,18,27,125,409,345,174,183,754
Clark961,32,13,2,6,4,43,125,107,55,45,232
Clark962,95,53,2,16,24,142,329,394,184,148,723
Clark963,91,101,9,15,12,94,367,270,130,192,637
Clark964,124,113,5,18,29,160,502,462,212,237,964
Clark965,86,75,5,15,31,139,400,406,190,161,806
Clark966,61,38,4,14,17,119,262,326,154,99,588
Clark967,61,47,3,19,19,100,300,277,141,108,577
Clark968,97,99,6,9,25,94,454,265,134,196,719
Clark969,57,74,7,13,18,94,295,256,132,131,551
Clark985,104,124,5,16,27,122,385,389,170,228,774
Columbia1,0,0,2,2,2,39,13,65,45,0,78
Columbia101,26,20,9,3,10,90,49,151,112,46,200
Columbia102,25,34,6,8,2,68,86,128,84,59,214
Columbia103,13,20,3,2,7,68,62,125,80,33,187
Columbia104,26,26,5,8,4,34,80,110,51,52,190
Columbia105,20,16,1,2,6,48,43,118,57,36,161
Columbia106,6,6,1,4,2,33,12,66,40,12,78
Columbia107,33,21,1,7,7,47,60,124,62,54,184
Columbia2,0,0,5,15,9,98,46,248,127,0,294
Columbia3,15,5,1,6,4,82,33,162,93,20,195
Columbia4,7,8,2,8,5,54,28,105,69,15,133
Columbia5,0,0,0,1,3,15,3,22,19,0,25
Columbia6,3,7,3,5,1,31,11,73,40,10,84
Cowlitz1,89,107,2,3,2,95,243,263,102,196,506
Cowlitz10,13,26,4,8,15,103,79,239,130,39,318
Cowlitz11,90,88,3,19,13,167,276,411,202,178,687
Cowlitz12,122,109,14,17,15,187,347,497,233,231,844
Cowlitz13,98,92,9,24,17,223,287,488,273,190,775
Cowlitz14,90,63,7,15,12,149,237,320,183,153,557
Cowlitz15,120,89,11,48,16,212,316,610,287,209,926
Cowlitz16,56,40,5,11,11,80,156,204,107,96,360
Cowlitz17,63,65,1,13,9,94,215,268,117,128,483
Cowlitz18,93,108,8,18,10,123,279,320,159,201,599
Cowlitz19,58,49,6,14,18,136,175,337,174,107,512
Cowlitz2,63,61,3,12,12,97,214,256,124,124,470
Cowlitz20,0,0,3,8,3,102,0,0,116,0,0
Cowlitz21,0,0,0,0,0,0,0,0,0,0,0
Cowlitz22,70,94,8,18,8,153,234,365,187,164,599
Cowlitz23,67,63,1,11,5,103,211,241,120,130,452
Cowlitz24,141,128,13,30,22,238,480,526,303,269,1006
Cowlitz25,166,107,10,14,27,124,366,326,175,273,692
Cowlitz26,0,0,0,0,0,0,0,0,0,0,0
Cowlitz27,86,85,2,15,6,102,216,244,125,171,460
Cowlitz28,99,105,9,30,7,171,285,412,217,204,697
Cowlitz29,180,169,13,12,19,135,474,394,179,349,868
Cowlitz3,35,34,6,7,7,78,104,192,98,69,296
Cowlitz30,100,115,8,7,6,87,283,271,108,215,554
Cowlitz31,131,88,11,25,21,151,377,373,208,219,750
Cowlitz32,96,109,13,29,20,336,317,734,398,205,1051
Cowlitz33,69,85,13,15,14,145,239,353,187,154,592
Cowlitz34,67,40,4,8,13,90,165,211,115,107,376
Cowlitz35,186,138,9,26,30,176,483,437,241,324,920
Cowlitz36,140,132,13,24,29,142,397,416,208,272,813
Cowlitz37,19,34,0,4,1,34,80,89,39,53,169
Cowlitz38,74,70,3,5,4,72,188,201,84,144,389
Cowlitz39,128,165,4,25,12,153,399,406,194,293,805
Cowlitz4,7,10,0,0,0,0,10,7,0,17,17
Cowlitz40,169,126,7,18,20,175,502,448,220,295,950
Cowlitz41,69,75,6,21,7,137,192,365,171,144,557
Cowlitz42,28,32,1,3,1,51,85,140,56,60,225
Cowlitz43,66,61,5,13,12,109,239,291,139,127,530
Cowlitz44,99,78,10,15,9,142,282,358,176,177,640
Cowlitz45,59,77,2,19,10,101,211,263,132,136,474
Cowlitz46,88,81,1,14,20,167,265,431,202,169,696
Cowlitz47,121,101,4,35,21,225,334,540,285,222,874
Cowlitz48,98,72,1,12,12,133,289,343,158,170,632
Cowlitz49,76,76,4,25,14,140,224,319,183,152,543
Cowlitz5,112,121,6,14,11,167,368,352,198,233,720
Cowlitz50,83,69,5,14,13,164,216,380,196,152,596
Cowlitz51,82,109,3,13,3,96,277,291,115,191,568
Cowlitz52,4,9,4,0,0,16,30,31,20,13,61
Cowlitz53,158,128,7,14,18,174,416,421,213,286,837
Cowlitz54,55,55,7,16,10,136,175,315,169,110,490
Cowlitz55,45,38,14,5,8,106,99,175,133,83,274
Cowlitz56,238,152,13,31,27,171,663,427,242,390,1090
Cowlitz57,78,87,12,19,8,139,228,380,178,165,608
Cowlitz58,113,134,14,28,17,287,331,654,346,247,985
Cowlitz59,45,43,2,16,9,79,139,267,106,88,406
Cowlitz6,113,125,8,30,6,168,356,511,212,238,867
Cowlitz60,51,58,2,9,4,48,155,131,63,109,286
Cowlitz61,74,96,9,21,15,164,243,386,209,170,629
Cowlitz62,70,101,9,14,15,230,235,527,268,171,762
Cowlitz63,117,99,10,22,19,267,299,618,318,216,917
Cowlitz64,37,32,4,11,8,76,85,180,99,69,265
Cowlitz65,70,73,3,18,11,101,190,252,133,143,442
Cowlitz66,26,45,3,4,0,47,95,104,54,71,199
Cowlitz67,31,30,1,3,8,41,75,105,53,61,180
Cowlitz68,138,119,10,15,26,177,417,499,228,257,916
Cowlitz69,64,65,14,28,21,165,178,408,228,129,586
Cowlitz7,6,3,0,0,0,0,18,19,0,9,37
Cowlitz70,110,114,16,44,23,328,319,697,411,224,1016
Cowlitz71,129,133,15,21,23,229,338,655,288,262,993
Cowlitz72,63,71,6,21,6,190,182,418,223,134,600
Cowlitz8,69,64,4,14,9,96,202,267,123,133,469
Cowlitz9,191,138,15,18,29,222,515,484,284,329,999
Douglas101,40,40,3,8,9,77,114,174,97,80,288
Douglas102,63,45,9,15,17,169,187,421,210,108,608
Douglas103,12,10,0,5,0,37,69,95,42,22,164
Douglas104,83,46,8,15,28,215,235,393,266,129,628
Douglas105,16,16,3,5,3,63,91,134,74,32,225
Douglas106,24,41,0,12,5,66,105,181,83,65,286
Douglas107,18,24,4,4,11,71,107,179,90,42,286
Douglas108,44,30,2,9,1,69,98,189,81,74,287
Douglas109,16,19,4,12,0,63,86,146,79,35,232
Douglas110,39,18,1,14,10,88,122,260,113,57,382
Douglas111,45,28,7,18,16,137,193,322,178,73,515
Douglas112,32,25,7,8,4,85,135,181,104,57,316
Douglas113,32,32,1,10,12,72,138,235,95,64,373
Douglas114,27,26,2,10,5,71,98,165,88,53,263
Douglas201,36,30,7,11,6,95,124,251,119,66,375
Douglas202,9,21,0,6,1,48,52,113,55,30,165
Douglas203,36,20,10,8,5,102,132,249,125,56,381
Douglas204,54,14,3,17,9,159,142,356,188,68,498
Douglas205,34,53,3,15,11,162,133,383,191,87,516
Douglas206,28,20,2,8,6,68,127,175,84,48,302
Douglas207,52,29,6,22,14,148,169,364,190,81,533
Douglas208,20,21,3,12,3,72,92,183,90,41,275
Douglas209,33,34,2,11,5,140,119,322,158,67,441
Douglas210,34,25,0,3,0,41,102,100,44,59,202
Douglas211,0,0,5,6,3,29,23,82,43,0,105
Douglas212,33,14,1,15,3,85,94,212,104,47,306
Douglas213,16,8,6,7,7,91,43,199,111,24,242
Douglas214,9,15,2,1,0,24,44,77,27,24,121
Douglas215,32,25,3,13,1,116,116,278,133,57,394
Douglas301,25,31,4,19,16,168,177,449,207,56,626
Douglas302,43,23,11,12,22,124,158,270,169,66,428
Douglas303,42,31,0,0,0,0,161,144,0,73,305
Douglas304,7,8,0,0,0,0,23,48,0,15,71
Douglas305,17,26,6,7,10,86,53,166,109,43,219
Douglas306,32,20,8,13,3,75,122,203,99,52,325
Douglas307,12,5,0,3,1,25,21,56,29,17,77
Douglas308,4,6,0,3,1,32,15,63,36,10,78
Douglas309,9,11,2,3,0,38,30,87,43,20,117
Douglas310,10,8,0,5,2,59,35,117,66,18,152
Douglas311,12,14,0,6,5,72,53,170,83,26,223
Douglas312,30,24,2,10,8,90,122,210,110,54,332
Douglas313,0,0,2,2,1,25,15,75,30,0,90
Douglas314,23,11,1,2,2,12,58,27,17,34,85
Douglas315,63,32,5,30,26,130,161,333,191,95,494
Douglas316,35,43,10,13,8,104,152,268,135,78,420
Douglas317,67,42,11,18,28,212,224,401,269,109,625
Douglas318,12,7,0,6,3,46,48,97,55,19,145
Ferry101,4,5,3,7,2,43,17,92,55,9,109
Ferry102,0,0,0,0,0,0,41,152,0,0,193
Ferry103,0,0,0,0,0,0,9,15,0,0,24
Ferry104,15,22,6,10,0,16,53,74,32,37,127
Ferry105,24,39,3,0,0,6,115,23,9,63,138
Ferry106,19,31,4,0,2,41,68,62,47,50,130
Ferry107,17,41,7,4,7,84,84,177,102,58,261
Ferry108,25,26,1,2,4,30,78,57,37,51,135
Ferry109,8,16,6,4,1,28,24,61,39,24,85
Ferry110,15,28,4,7,4,69,52,135,84,43,187
Ferry111,14,22,3,8,2,57,48,106,70,36,154
Ferry112,21,28,3,12,5,66,73,126,86,49,199
Ferry113,16,27,1,1,7,39,72,110,48,43,182
Ferry114,12,29,7,7,7,82,71,192,103,41,263
Ferry115,27,25,2,8,3,98,62,197,111,52,259
Ferry116,14,21,3,7,2,56,47,121,68,35,168
Ferry117,11,23,7,9,6,78,55,187,100,34,242
Ferry118,10,9,6,7,3,46,36,94,62,19,130
Ferry119,31,49,4,9,3,115,93,221,131,80,314
Franklin1,104,80,4,9,2,31,476,97,46,184,573
Franklin10,35,16,2,5,7,37,102,83,51,51,185
Franklin100,0,0,0,4,1,51,15,116,56,0,131
Franklin101,7,4,6,14,2,57,27,146,79,11,173
Franklin102,0,0,0,0,0,0,0,0,0,0,0
Franklin103,0,0,0,2,2,8,14,34,12,0,48
Franklin104,0,0,0,0,0,0,5,13,0,0,18
Franklin11,26,21,0,6,4,22,120,66,32,47,186
Franklin12,22,17,0,0,0,0,128,60,0,39,188
Franklin13,39,26,1,6,3,11,142,49,21,65,191
Franklin14,27,20,2,4,2,30,115,77,38,47,192
Franklin15,21,25,0,0,0,0,120,61,0,46,181
Franklin16,9,10,0,0,0,0,42,8,0,19,50
Franklin17,32,28,3,6,2,26,135,70,37,60,205
Franklin18,23,12,0,5,1,24,65,54,30,35,119
Franklin19,40,21,6,11,6,43,165,142,66,61,307
Franklin2,64,40,2,1,0,28,282,64,31,104,346
Franklin20,14,6,3,11,1,26,45,88,41,20,133
Franklin21,11,6,0,5,1,17,41,38,23,17,79
Franklin22,26,36,6,24,7,92,145,266,129,62,411
Franklin23,52,40,6,12,5,125,200,294,148,92,494
Franklin24,23,12,4,6,2,48,57,111,60,35,168
Franklin25,10,7,3,2,6,21,31,58,32,17,89
Franklin26,18,19,1,12,2,36,60,93,51,37,153
Franklin27,12,9,1,2,2,25,48,81,30,21,129
Franklin28,12,7,2,7,4,20,57,62,33,19,119
Franklin29,18,5,0,4,2,37,42,81,43,23,123
Franklin3,27,22,0,1,2,17,92,42,20,49,134
Franklin30,4,4,0,0,0,0,24,55,0,8,79
Franklin31,3,7,0,0,0,0,21,60,0,10,81
Franklin32,51,63,11,51,9,118,247,441,189,114,688
Franklin33,22,24,6,9,3,32,98,109,50,46,207
Franklin34,35,24,7,12,8,88,130,205,115,59,335
Franklin35,24,11,6,19,7,73,77,211,105,35,288
Franklin36,45,30,0,16,7,85,163,208,108,75,371
Franklin37,37,58,6,24,11,108,257,349,149,95,606
Franklin38,23,22,1,9,8,53,111,166,71,45,277
Franklin39,25,39,6,17,4,73,152,221,100,64,373
Franklin4,45,20,0,3,0,13,150,42,16,65,192
Franklin40,45,59,6,20,6,56,241,219,88,104,460
Franklin41,26,15,5,6,2,49,83,117,62,41,200
Franklin42,24,25,1,14,7,47,119,165,69,49,284
Franklin43,24,24,5,12,6,58,110,190,81,48,300
Franklin44,43,23,5,13,2,61,134,174,81,66,308
Franklin45,46,33,6,11,4,96,220,300,117,79,520
Franklin46,32,35,10,23,4,91,174,300,128,67,474
Franklin47,4,2,0,0,3,10,10,19,13,6,29
Franklin48,21,27,1,18,9,64,96,199,92,48,295
Franklin49,28,13,4,14,7,107,95,235,132,41,330
Franklin5,38,13,1,2,0,19,141,42,22,51,183
Franklin50,41,37,1,22,7,79,175,240,109,78,415
Franklin51,29,31,11,11,6,86,155,253,114,60,408
Franklin52,10,28,1,5,0,27,101,96,33,38,197
Franklin53,31,41,7,16,2,56,150,170,81,72,320
Franklin54,24,12,1,9,1,46,80,120,57,36,200
Franklin55,42,36,10,16,18,138,178,312,182,78,490
Franklin56,23,20,5,15,6,64,129,182,90,43,311
Franklin57,19,20,6,7,7,76,71,200,96,39,271
Franklin58,0,0,2,1,0,12,6,28,15,0,34
Franklin59,31,29,9,11,13,77,144,212,110,60,356
Franklin6,35,31,2,3,0,25,195,58,30,66,253
Franklin60,11,8,2,2,4,40,36,66,48,19,102
Franklin61,21,12,4,17,6,66,97,233,93,33,330
Franklin62,34,20,6,29,13,112,161,333,160,54,494
Franklin63,16,21,7,22,0,68,80,199,97,37,279
Franklin64,4,10,4,16,3,81,42,175,104,14,217
Franklin65,10,6,0,5,5,22,37,85,32,16,122
Franklin66,27,22,4,20,5,99,90,283,128,49,373
Franklin67,21,19,1,12,7,85,0,0,105,40,0
Franklin68,0,0,0,0,0,0,0,0,0,0,0
Franklin69,0,0,0,0,0,0,13,33,0,0,46
Franklin7,26,41,4,9,5,18,142,63,36,67,205
Franklin70,2,3,0,5,2,8,10,52,15,5,62
Franklin71,6,13,4,10,2,72,37,200,88,19,237
Franklin72,17,9,1,8,3,50,93,111,62,26,204
Franklin73,25,25,2,19,10,133,129,345,164,50,474
Franklin74,13,8,6,17,13,90,43,246,126,21,289
Franklin75,3,4,0,0,0,0,10,43,0,7,53
Franklin76,6,5,2,15,0,32,15,91,49,11,106
Franklin77,0,0,2,5,0,25,16,72,32,0,88
Franklin78,0,0,1,9,0,35,11,117,45,0,128
Franklin79,2,6,7,17,1,24,9,108,49,8,117
Franklin8,34,16,3,7,7,90,69,184,107,50,253
Franklin80,4,14,12,24,7,99,49,285,142,18,334
Franklin81,2,2,1,12,1,13,6,68,27,4,74
Franklin82,10,10,2,13,2,33,37,114,50,20,151
Franklin83,2,10,2,10,0,39,11,91,51,12,102
Franklin84,7,8,3,4,0,18,37,41,25,15,78
Franklin85,5,8,1,5,2,10,54,31,18,13,85
Franklin86,2,2,5,11,4,34,5,101,54,4,106
Franklin87,4,3,0,4,1,33,21,75,38,7,96
Franklin88,4,6,0,4,0,9,13,43,13,10,56
Franklin89,7,9,2,13,1,46,28,129,62,16,157
Franklin9,37,27,2,0,2,14,147,34,18,64,181
Franklin90,29,27,3,12,1,69,81,151,85,56,232
Franklin91,0,0,0,0,0,0,11,5,0,0,16
Franklin92,13,17,2,17,2,48,59,114,69,30,173
Franklin93,16,20,6,7,10,56,52,156,79,36,208
Franklin94,0,0,0,0,0,0,0,0,0,0,0
Franklin95,6,6,1,5,2,15,8,46,23,12,54
Franklin96,0,0,4,3,7,40,12,96,54,0,108
Franklin97,8,5,0,5,0,32,10,55,37,13,65
Franklin98,0,0,0,0,2,14,9,27,16,0,36
Franklin99,3,2,0,12,2,9,5,31,23,5,36
Garfield101,0,0,0,0,0,0,0,0,0,0,0
Garfield102,4,2,2,5,1,12,0,0,20,6,0
Garfield103,0,0,0,0,0,0,30,138,0,0,168
Garfield104,0,0,0,0,0,0,3,13,0,0,16
Garfield105,0,0,0,0,0,0,4,17,0,0,21
Garfield106,2,4,2,5,0,11,7,50,18,6,57
Garfield109,6,6,1,7,5,39,16,85,52,12,101
Garfield110,3,2,2,3,4,21,15,44,30,5,59
Garfield201,9,9,0,6,7,21,28,73,34,18,101
Garfield202,22,19,1,18,6,46,64,140,71,41,204
Garfield203,19,14,3,21,7,53,53,151,84,33,204
Garfield204,17,19,5,7,3,46,51,106,61,36,157
Grant1,39,44,7,9,3,129,119,261,148,83,380
Grant10,34,37,2,7,3,78,112,162,90,71,274
Grant11,62,47,8,9,6,172,146,376,195,109,522
Grant12,34,36,13,14,11,119,103,299,157,70,402
Grant13,49,77,13,28,16,186,243,459,243,126,702
Grant14,11,24,9,10,8,115,52,223,142,35,275
Grant15,6,9,0,0,0,0,39,30,0,15,69
Grant16,52,40,11,29,23,241,167,507,304,92,674
Grant17,21,13,4,8,1,156,56,322,169,34,378
Grant18,63,43,6,14,5,87,145,175,112,106,320
Grant19,3,4,5,7,3,21,18,60,36,7,78
Grant2,0,0,0,2,0,15,13,29,17,0,42
Grant20,0,0,0,2,1,8,8,25,11,0,33
Grant21,18,18,7,11,2,134,84,273,154,36,357
Grant22,39,25,18,10,8,170,134,420,206,64,554
Grant23,73,55,23,30,21,406,196,887,480,128,1083
Grant24,0,0,0,0,0,0,4,17,0,0,21
Grant25,3,4,0,0,0,0,5,45,0,7,50
Grant26,26,34,0,2,0,7,131,13,9,60,144
Grant27,73,64,17,13,9,203,223,433,242,137,656
Grant28,20,16,5,10,2,99,59,194,116,36,253
Grant29,34,39,5,18,6,87,128,240,116,73,368
Grant3,34,48,12,36,15,261,157,598,324,82,755
Grant30,54,66,12,39,12,162,207,458,225,120,665
Grant31,38,57,10,9,9,122,182,279,150,95,461
Grant32,91,69,10,29,7,159,303,441,205,160,744
Grant33,60,54,14,18,9,176,245,438,217,114,683
Grant34,95,71,22,28,10,211,258,523,271,166,781
Grant35,57,73,8,16,14,230,230,569,268,130,799
Grant36,47,50,9,12,12,163,148,354,196,97,502
Grant37,16,15,1,6,2,36,39,77,45,31,116
Grant38,27,17,6,42,7,236,84,518,291,44,602
Grant39,72,52,3,6,7,77,271,191,93,124,462
Grant4,41,32,4,8,5,76,120,190,93,73,310
Grant40,37,27,3,6,1,24,134,91,34,64,225
Grant41,90,44,9,22,30,139,261,371,200,134,632
Grant42,23,19,7,8,5,81,62,202,101,42,264
Grant43,44,24,6,30,13,214,123,452,263,68,575
Grant44,21,17,4,7,2,24,90,70,37,38,160
Grant45,0,0,1,4,0,24,6,52,29,0,58
Grant46,13,11,1,5,2,58,37,126,66,24,163
Grant47,33,45,3,6,2,90,103,196,101,78,299
Grant48,8,10,1,4,0,39,29,88,44,18,117
Grant49,0,0,0,8,0,19,3,40,27,0,43
Grant5,14,11,1,10,3,89,51,195,103,25,246
Grant50,45,21,5,13,2,65,131,164,85,66,295
Grant51,22,29,11,35,14,160,86,418,220,51,504
Grant52,27,35,6,7,4,65,82,162,82,62,244
Grant53,0,0,0,5,2,45,30,112,52,0,142
Grant54,26,15,3,7,8,92,70,218,110,41,288
Grant55,11,14,0,2,2,29,32,49,33,25,81
Grant56,2,2,0,0,0,0,3,40,0,4,43
Grant57,31,40,2,6,3,87,120,175,98,71,295
Grant58,70,60,10,25,14,265,248,585,314,130,833
Grant59,2,6,2,5,2,27,29,73,36,8,102
Grant6,14,4,2,1,1,32,26,80,36,18,106
Grant60,0,0,3,0,0,17,6,29,20,0,35
Grant61,4,3,0,15,1,31,18,91,47,7,109
Grant62,0,0,0,0,0,0,3,15,0,0,18
Grant63,22,23,4,6,2,77,39,151,89,45,190
Grant64,56,36,19,26,12,227,193,505,284,92,698
Grant65,3,5,0,0,0,0,11,57,0,8,68
Grant66,20,33,6,7,7,114,93,256,134,53,349
Grant67,72,41,4,19,6,65,167,216,94,113,383
Grant68,50,28,5,15,19,138,129,343,177,78,472
Grant69,62,34,11,31,32,234,219,601,308,96,820
Grant7,57,42,11,13,13,130,144,260,167,99,404
Grant70,62,22,19,27,13,291,170,649,350,84,819
Grant71,38,31,15,11,4,169,96,338,199,69,434
Grant72,7,4,0,4,0,31,17,71,35,11,88
Grant73,6,2,2,3,1,8,10,40,14,8,50
Grant74,21,22,2,20,12,116,90,313,150,43,403
Grant8,48,43,2,11,6,111,111,244,130,91,355
Grant9,22,25,12,22,18,106,109,294,158,47,403
Grays Harbor10,6,8,0,0,0,0,19,39,0,14,58
Grays Harbor111,143,120,6,8,7,144,381,384,165,263,765
Grays Harbor12,72,52,0,4,8,84,199,202,96,124,401
Grays Harbor121,95,115,4,5,8,134,325,334,151,210,659
Grays Harbor131,144,117,6,10,12,158,448,380,186,261,828
Grays Harbor132,0,0,0,0,0,0,0,0,0,0,0
Grays Harbor14,5,8,0,0,0,0,19,20,0,13,39
Grays Harbor141,118,81,2,5,12,118,352,311,137,199,663
Grays Harbor142,88,98,4,8,5,100,321,291,117,186,612
Grays Harbor151,67,103,6,10,4,91,253,272,111,170,525
Grays Harbor16,10,12,1,5,2,27,38,86,35,22,124
Grays Harbor161,110,121,6,11,12,139,381,356,168,231,737
Grays Harbor18,10,5,0,2,0,14,26,39,16,15,65
Grays Harbor2,46,52,0,0,0,0,227,17,0,98,244
Grays Harbor20,13,27,0,2,1,58,53,125,61,40,178
Grays Harbor201,94,83,12,12,17,124,308,390,165,177,698
Grays Harbor22,5,9,0,5,0,22,19,60,27,14,79
Grays Harbor24,48,47,6,3,3,86,151,198,98,95,349
Grays Harbor26,0,0,0,0,0,0,25,61,0,0,86
Grays Harbor28,0,0,0,0,0,0,0,0,0,0,0
Grays Harbor30,13,43,9,9,6,69,81,218,93,56,299
Grays Harbor301,42,46,1,3,10,59,140,186,73,88,326
Grays Harbor302,87,78,8,13,10,155,288,386,186,165,674
Grays Harbor32,15,18,0,0,0,0,41,59,0,33,100
Grays Harbor34,43,41,6,4,4,83,127,194,97,84,321
Grays Harbor36,5,11,0,0,0,0,18,29,0,16,47
Grays Harbor38,0,0,0,0,0,0,0,0,0,0,0
Grays Harbor4,26,26,0,5,2,33,64,98,40,52,162
Grays Harbor40,21,25,1,5,0,40,66,88,46,46,154
Grays Harbor411,66,59,1,5,1,91,232,241,98,125,473
Grays Harbor42,0,0,0,0,0,0,4,3,0,0,7
Grays Harbor421,68,64,2,6,7,68,204,181,83,132,385
Grays Harbor431,73,77,4,9,7,78,253,213,98,150,466
Grays Harbor44,4,4,0,0,2,23,29,47,25,8,76
Grays Harbor441,110,57,3,7,11,84,279,236,105,167,515
Grays Harbor451,49,82,0,10,4,55,203,200,69,131,403
Grays Harbor46,64,94,5,15,11,130,226,348,161,158,574
Grays Harbor461,52,55,1,9,0,71,189,193,81,107,382
Grays Harbor48,75,62,8,7,6,105,247,309,126,137,556
Grays Harbor50,3,5,0,4,0,21,9,40,25,8,49
Grays Harbor501,77,92,10,9,8,126,252,344,153,169,596
Grays Harbor52,22,23,3,2,2,49,76,144,56,45,220
Grays Harbor56,26,38,4,4,4,69,133,243,81,64,376
Grays Harbor58,69,97,6,14,10,183,302,437,213,166,739
Grays Harbor6,3,9,2,0,2,28,35,62,32,12,97
Grays Harbor60,60,63,6,8,9,134,209,365,157,123,574
Grays Harbor601,110,134,14,11,17,173,428,429,215,244,857
Grays Harbor602,123,124,5,11,8,145,423,427,169,247,850
Grays Harbor603,0,0,0,0,0,0,0,0,0,0,0
Grays Harbor62,29,26,3,2,4,56,103,188,65,55,291
Grays Harbor64,16,10,0,1,3,34,40,98,38,26,138
Grays Harbor66,0,0,0,0,0,0,4,2,0,0,6
Grays Harbor68,57,41,0,9,6,90,187,239,105,98,426
Grays Harbor70,52,45,3,14,8,119,183,301,144,97,484
Grays Harbor701,15,17,0,9,4,68,63,148,81,32,211
Grays Harbor72,30,52,2,6,14,100,130,261,122,82,391
Grays Harbor74,51,39,2,5,2,67,135,169,76,90,304
Grays Harbor76,5,11,0,1,3,11,32,40,15,16,72
Grays Harbor78,9,6,2,2,2,28,30,50,34,15,80
Grays Harbor8,51,43,2,4,7,35,157,95,48,94,252
Grays Harbor80,115,89,9,14,18,148,328,386,189,204,714
Grays Harbor801,146,134,6,18,12,208,464,416,244,280,880
Grays Harbor802,197,163,18,20,19,298,560,584,355,360,1144
Grays Harbor803,168,147,8,16,20,247,508,529,291,315,1037
Grays Harbor82,19,12,1,0,2,24,65,81,27,31,146
Grays Harbor84,38,21,0,2,6,55,102,129,63,59,231
Grays Harbor86,0,0,0,0,0,0,0,0,0,0,0
Grays Harbor88,15,12,0,0,0,0,37,59,0,27,96
Grays Harbor90,7,2,0,0,0,0,13,11,0,9,24
Grays Harbor901,100,109,8,13,9,187,357,447,217,209,804
Grays Harbor92,0,0,0,0,0,0,0,0,0,0,0
Grays Harbor94,48,59,4,3,3,92,152,204,102,107,356
Grays Harbor96,47,47,3,11,5,97,144,220,116,94,364
Grays Harbor98,45,34,1,2,2,42,119,119,47,79,238
Island150,72,76,13,32,26,119,229,318,190,148,547
Island151,185,143,4,53,46,201,533,504,304,328,1037
Island152,180,135,12,45,53,153,558,373,263,315,931
Island153,248,191,9,37,51,167,661,370,264,439,1031
Island154,162,188,4,39,36,159,523,448,238,350,971
Island155,213,144,7,35,49,151,631,324,242,357,955
Island160,248,203,5,23,30,182,657,360,240,451,1017
Island161,221,181,5,38,32,158,738,351,233,402,1089
Island162,231,217,6,38,33,148,731,390,225,448,1121
Island163,243,215,8,15,36,107,756,245,166,458,1001
Island164,224,265,5,33,25,127,793,308,190,489,1101
Island165,213,132,2,21,48,176,651,343,247,345,994
Island166,218,222,4,7,18,48,668,103,77,440,771
Island167,222,202,3,18,38,167,711,333,226,424,1044
Island168,148,215,4,11,12,90,690,248,117,363,938
Island169,194,204,10,31,13,170,690,404,224,398,1094
Island170,195,201,6,28,25,137,691,308,196,396,999
Island201,119,100,13,38,48,204,381,512,303,219,893
Island202,54,66,8,41,27,137,240,425,213,120,665
Island203,115,99,14,41,28,159,365,431,242,214,796
Island204,101,121,10,48,23,166,399,491,247,222,890
Island205,119,80,14,34,32,186,314,426,266,199,740
Island206,107,117,14,45,18,156,368,397,233,224,765
Island207,124,136,10,37,30,184,468,459,261,260,927
Island208,72,118,13,37,18,163,282,422,231,190,704
Island209,26,49,5,34,6,78,189,294,123,75,483
Island251,64,58,4,25,33,122,171,302,184,122,473
Island252,61,75,8,29,55,136,257,438,228,136,695
Island253,68,57,3,30,27,139,215,330,199,125,545
Island254,78,44,2,25,28,133,241,336,188,122,577
Island255,19,18,4,15,4,61,63,115,84,37,178
Island256,11,23,1,8,10,26,58,78,45,34,136
Island301,121,86,10,31,17,160,360,354,218,207,714
Island302,130,121,13,32,31,212,440,459,288,251,899
Island303,171,118,13,44,27,201,423,451,285,289,874
Island304,193,135,13,38,42,231,536,568,324,328,1104
Island305,155,93,7,36,39,196,455,517,278,248,972
Island306,167,123,13,36,30,194,502,516,273,290,1018
Island307,131,100,8,32,37,184,410,403,261,231,813
Island308,80,90,4,23,15,135,281,347,177,170,628
Island309,154,100,13,36,27,177,408,419,253,254,827
Island310,134,100,5,21,31,147,381,325,204,234,706
Island311,156,100,9,21,32,192,452,413,254,256,865
Island351,115,95,18,52,38,212,325,583,320,210,908
Island352,72,109,12,50,32,247,311,593,341,181,904
Island353,59,86,8,30,22,168,271,402,228,145,673
Island354,85,112,19,56,50,241,328,631,366,197,959
Island355,40,57,8,29,30,122,155,298,189,97,453
Jefferson101,80,36,0,4,6,44,168,83,54,116,251
Jefferson102,45,72,2,0,6,46,164,106,54,117,270
Jefferson103,17,47,4,6,5,43,89,95,58,64,184
Jefferson104,172,163,2,5,14,63,468,132,84,335,600
Jefferson105,144,154,4,10,15,60,473,145,89,298,618
Jefferson106,85,182,1,0,11,39,362,106,51,267,468
Jefferson107,84,175,11,5,9,80,391,184,105,259,575
Jefferson200,48,72,2,3,6,40,154,123,51,120,277
Jefferson201,76,124,6,12,13,114,246,300,145,200,546
Jefferson204,94,111,8,21,16,203,315,417,248,205,732
Jefferson300,71,92,5,10,9,102,240,208,126,163,448
Jefferson301,42,57,3,9,2,35,136,114,49,99,250
Jefferson302,44,90,2,2,7,51,213,168,62,134,381
Jefferson303,114,145,5,11,16,118,388,262,150,259,650
Jefferson304,200,100,7,15,52,96,463,198,170,300,661
Jefferson305,72,121,0,9,1,76,276,179,86,193,455
Jefferson306,95,165,8,4,6,133,338,320,151,260,658
Jefferson307,68,77,2,10,11,55,234,140,78,145,374
Jefferson308,28,62,0,7,2,25,138,86,34,90,224
Jefferson401,133,144,4,12,20,79,441,180,115,277,621
Jefferson500,172,93,8,17,36,199,428,369,260,265,797
Jefferson501,176,99,11,8,35,134,403,272,188,275,675
Jefferson502,82,93,2,9,18,94,277,202,123,175,479
Jefferson503,114,37,7,3,24,120,261,231,154,151,492
Jefferson504,70,48,2,4,9,76,201,146,91,118,347
Jefferson505,110,88,0,0,0,0,296,255,0,198,551
Jefferson600,13,24,0,0,0,0,43,39,0,37,82
Jefferson601,2,7,0,0,0,0,24,25,0,9,49
Jefferson700,139,181,2,4,7,50,492,111,63,320,603
Jefferson701,61,90,0,1,6,19,227,35,26,151,262
Jefferson702,98,109,2,1,9,14,303,38,26,207,341
Jefferson703,97,124,1,0,5,33,368,54,39,221,422
Jefferson704,63,129,0,0,3,8,266,30,11,192,296
Jefferson705,78,124,1,1,5,44,284,95,51,202,379
Jefferson706,189,336,4,4,11,67,785,178,86,525,963
Jefferson707,189,239,5,8,10,57,668,130,80,428,798
Jefferson708,198,273,2,4,9,56,675,123,71,471,798
Jefferson709,179,247,3,7,7,38,583,81,55,426,664
Jefferson710,117,144,4,0,10,34,375,77,48,261,452
King1,57,70,3,5,2,13,290,48,23,127,338
King10,52,22,2,6,11,34,243,117,53,74,360
King100,98,33,1,7,21,49,374,153,78,131,527
King1000,40,40,1,4,6,31,317,113,42,80,430
King1002,44,31,1,1,1,29,191,62,32,75,253
King1004,38,21,0,2,0,30,174,71,32,59,245
King1006,52,31,3,7,3,32,222,114,45,83,336
King1007,26,27,1,3,4,24,167,64,32,53,231
King1008,56,67,1,19,2,43,288,167,65,123,455
King101,80,46,2,4,13,19,278,85,38,126,363
King1010,39,23,1,5,11,33,214,116,50,62,330
King1011,84,45,2,11,2,41,346,153,56,129,499
King1012,60,60,1,6,4,45,330,120,56,120,450
King1015,47,37,3,8,3,25,250,95,39,84,345
King1017,55,44,4,7,9,56,274,158,76,99,432
King1018,108,36,3,10,18,73,394,190,104,144,584
King1019,70,73,2,10,6,50,370,160,68,143,530
King102,69,28,0,5,11,43,270,98,59,97,368
King1020,44,26,1,0,10,29,184,58,40,70,242
King1021,75,94,1,4,5,28,379,65,38,169,444
King1022,79,79,2,8,8,65,384,224,83,158,608
King1023,47,22,0,5,10,36,197,81,51,69,278
King1024,35,25,2,5,2,55,127,166,64,60,293
King1026,78,86,3,2,5,53,334,131,63,164,465
King103,71,18,1,7,22,45,262,121,75,89,383
King1030,30,56,0,0,2,11,184,36,13,86,220
King1031,85,66,3,4,4,48,369,123,59,151,492
King1032,76,49,3,6,5,35,284,87,49,125,371
King1034,83,56,6,15,19,55,364,175,95,139,539
King1035,43,43,0,13,1,35,200,163,49,86,363
King1036,69,47,1,2,7,18,250,47,28,116,297
King1038,38,49,0,3,0,10,177,29,13,87,206
King1040,111,73,1,23,9,47,440,163,80,184,603
King1047,106,94,3,2,3,38,395,114,46,200,509
King1049,44,18,1,4,17,39,164,100,61,62,264
King1052,56,33,5,8,16,34,237,107,63,89,344
King1053,65,33,3,5,7,29,207,83,44,98,290
King1055,48,35,0,4,0,25,201,69,29,83,270
King1056,93,49,2,14,7,27,346,73,50,142,419
King1057,106,71,3,10,18,63,396,143,94,177,539
King1058,100,40,5,7,22,48,304,125,82,140,429
King1059,82,81,1,7,10,55,368,121,73,163,489
King106,55,28,0,9,8,37,246,106,54,83,352
King1061,64,49,0,1,4,13,250,58,18,113,308
King1062,61,45,2,21,6,126,226,341,155,106,567
King1064,92,54,2,8,9,49,359,123,68,146,482
King1066,41,30,1,6,9,39,139,117,55,71,256
King1067,57,40,2,7,7,36,227,117,52,97,344
King1068,58,32,4,11,9,92,206,222,116,90,428
King1069,122,67,3,1,7,33,415,104,44,189,519
King1070,34,30,3,5,10,38,174,111,56,64,285
King1071,47,38,2,8,2,30,198,86,42,85,284
King1073,101,82,0,1,3,19,329,47,23,183,376
King1075,67,41,2,5,5,30,228,74,42,108,302
King1076,67,74,4,8,10,44,325,171,66,141,496
King1077,49,67,2,1,2,8,294,60,13,116,354
King1078,35,34,0,4,2,23,161,76,29,69,237
King108,58,38,2,1,8,46,245,107,57,96,352
King1080,31,41,0,6,3,13,155,42,22,72,197
King1082,56,40,2,3,8,33,179,82,46,96,261
King1084,55,45,3,11,6,103,201,308,123,100,509
King1085,1,2,0,0,0,0,10,0,0,3,10
King1088,39,47,1,10,5,59,177,138,75,86,315
King1089,97,58,2,2,11,28,366,85,43,155,451
King109,31,30,0,0,6,11,180,55,17,61,235
King1091,10,29,1,1,3,12,49,26,17,39,75
King1095,97,62,4,9,17,56,409,183,86,159,592
King1096,51,60,4,2,6,69,292,228,81,111,520
King1097,33,44,4,7,1,27,162,89,39,77,251
King1099,64,77,3,14,13,96,290,264,126,141,554
King11,38,29,0,4,0,23,188,61,27,67,249
King110,72,56,1,6,6,43,334,108,56,128,442
King1101,35,48,0,2,1,17,177,60,20,83,237
King1102,101,46,5,13,11,73,391,198,102,147,589
King1104,40,36,3,10,4,25,191,79,42,76,270
King1106,88,74,0,4,4,26,368,95,34,162,463
King1107,51,59,5,15,8,92,239,296,120,110,535
King1109,64,43,1,3,2,28,250,96,34,107,346
King111,81,50,2,7,13,43,330,122,65,131,452
King1110,74,68,9,19,15,88,298,264,131,142,562
King1112,12,11,2,2,1,8,62,26,13,23,88
King1113,14,13,0,2,3,23,88,55,28,27,143
King1114,6,5,1,0,0,2,18,2,3,11,20
King1115,71,41,2,9,13,56,352,166,80,112,518
King1116,54,47,1,5,1,21,216,61,28,101,277
King1117,38,17,1,6,7,30,141,97,44,55,238
King112,92,41,2,12,19,64,376,171,97,133,547
King1121,23,43,0,1,3,29,94,67,33,66,161
King1122,33,41,8,9,10,73,201,154,100,74,355
King1125,73,54,0,5,3,51,358,145,59,127,503
King1127,41,46,2,12,9,44,242,200,67,87,442
King1128,40,35,3,3,2,26,139,71,34,75,210
King113,28,22,0,6,10,23,161,48,39,50,209
King1130,75,35,1,6,2,33,315,134,42,110,449
King1131,65,103,2,4,1,32,400,88,39,168,488
King1135,107,104,3,4,3,53,483,122,63,211,605
King1136,31,23,2,3,1,22,112,63,28,54,175
King1138,103,123,3,3,4,29,372,73,39,226,445
King1139,50,36,3,6,7,94,195,286,110,86,481
King114,55,23,2,6,15,48,269,112,71,78,381
King1140,33,36,0,3,3,11,160,43,17,69,203
King1141,51,48,7,10,15,84,258,252,116,99,510
King1143,68,68,1,3,14,30,264,85,48,136,349
King1145,87,46,5,9,13,58,301,179,85,133,480
King1146,71,49,1,11,6,45,272,146,63,120,418
King1147,85,84,3,4,3,49,459,155,59,169,614
King1150,40,23,4,9,8,48,204,107,69,63,311
King1151,47,24,4,6,12,50,159,151,72,71,310
King1152,84,74,1,10,11,75,378,208,97,158,586
King1153,62,37,4,9,4,66,229,199,83,99,428
King1156,11,24,3,9,7,45,121,104,64,35,225
King1158,53,45,1,4,2,15,196,36,22,98,232
King1159,39,30,3,7,10,88,237,275,108,69,512
King116,29,31,0,4,1,8,180,33,13,60,213
King1164,104,80,2,2,6,48,410,136,58,184,546
King1165,82,71,1,6,7,56,398,145,70,153,543
King1166,52,52,1,1,0,24,215,70,26,104,285
King1167,0,0,0,0,1,0,2,1,1,0,3
King1168,74,68,0,3,7,28,288,72,38,142,360
King117,49,20,3,3,4,13,145,39,23,69,184
King1170,37,15,1,10,10,34,180,109,55,52,289
King1171,67,69,1,9,2,46,316,100,58,136,416
King1172,90,65,3,12,23,83,335,241,121,155,576
King1178,45,83,1,4,2,21,224,56,28,128,280
King1179,65,44,0,2,11,56,321,154,69,109,475
King1181,48,16,0,10,7,27,179,68,44,64,247
King1183,53,43,1,10,16,42,239,132,69,96,371
King1186,74,62,3,1,4,17,288,48,25,136,336
King1187,61,94,0,0,1,17,300,43,18,155,343
King1188,50,37,7,13,14,103,171,302,137,87,473
King1189,62,52,3,4,4,54,315,133,65,114,448
King119,66,20,1,1,13,24,187,57,39,86,244
King1191,43,23,0,7,6,46,189,115,59,66,304
King1192,108,67,2,7,14,52,355,119,75,175,474
King1195,23,13,1,2,2,67,92,139,72,36,231
King1196,64,48,2,3,0,17,292,59,22,112,351
King1197,45,48,1,5,2,22,202,50,30,93,252
King1198,31,34,2,10,6,35,181,108,53,65,289
King12,66,55,0,1,3,17,296,45,21,121,341
King120,26,19,2,0,12,18,124,59,32,45,183
King1203,49,43,4,14,12,62,243,223,92,92,466
King1204,131,74,5,6,14,97,454,230,122,205,684
King1205,47,48,4,10,12,59,266,153,85,95,419
King1207,42,57,3,0,7,34,300,112,44,99,412
King1208,86,59,4,8,26,59,342,189,97,145,531
King1209,65,70,2,8,4,14,319,53,28,135,372
King121,65,37,0,4,9,35,367,101,48,102,468
King1210,85,73,1,4,2,24,373,49,31,158,422
King1215,112,106,6,8,2,32,494,82,48,218,576
King1216,42,40,2,11,9,127,161,281,149,82,442
King1218,65,62,2,7,9,69,302,212,87,127,514
King1219,62,49,1,4,13,57,279,155,75,111,434
King122,56,22,1,2,10,53,199,110,66,78,309
King1224,97,71,0,7,15,45,400,164,67,168,564
King1225,49,20,1,3,5,31,261,117,40,69,378
King1227,79,64,4,14,15,79,281,195,112,143,476
King1228,36,42,2,6,6,9,221,48,23,78,269
King123,88,76,3,2,16,40,407,126,61,164,533
King1230,40,17,1,15,12,66,120,161,94,57,281
King1231,55,57,0,1,3,29,276,74,33,112,350
King1233,35,14,0,4,16,43,201,110,63,49,311
King1234,64,14,1,2,13,37,208,97,53,78,305
King1235,47,24,0,1,3,33,175,76,37,71,251
King1236,33,63,0,0,3,10,189,28,13,96,217
King1237,68,37,2,2,9,27,297,56,40,105,353
King124,87,23,1,4,14,33,328,91,52,110,419
King1245,63,70,0,4,2,17,311,46,23,133,357
King1246,47,63,0,2,2,19,227,54,23,110,281
King1247,58,63,1,3,0,13,306,50,17,121,356
King1248,54,54,2,3,1,20,277,59,26,108,336
King1249,50,83,0,1,1,9,377,47,11,133,424
King125,47,46,1,4,5,29,218,73,39,93,291
King1250,45,76,0,0,1,8,248,25,9,121,273
King1251,152,62,0,10,1,34,388,84,45,214,472
King1252,56,96,2,3,0,33,451,74,38,152,525
King1254,33,58,2,0,3,9,241,29,14,91,270
King1255,75,43,1,1,4,22,258,54,28,118,312
King1256,62,66,1,1,0,25,390,79,27,128,469
King1257,63,54,1,8,9,28,360,72,46,117,432
King1258,65,37,2,2,2,29,230,69,35,102,299
King1259,70,47,0,1,4,9,243,32,14,117,275
King126,52,30,0,5,16,21,198,69,42,82,267
King1262,78,76,0,1,2,12,372,27,15,154,399
King1263,61,44,0,1,3,5,274,13,9,105,287
King1264,60,42,0,0,0,4,283,17,4,102,300
King1265,23,36,0,0,1,5,214,16,6,59,230
King1266,49,53,0,0,6,9,293,19,15,102,312
King1267,104,55,0,0,3,0,340,19,3,159,359
King1268,76,48,0,1,5,7,303,19,13,124,322
King1269,62,56,1,1,2,7,293,21,11,118,314
King127,51,28,0,9,2,18,196,65,29,79,261
King1271,61,101,0,1,3,7,580,43,11,162,623
King1272,97,58,0,1,1,5,381,23,7,155,404
King1273,52,37,0,0,1,7,249,16,8,89,265
King1274,41,47,0,2,2,12,248,28,16,88,276
King1275,42,47,1,2,1,11,226,24,15,89,250
King1277,80,84,0,5,5,11,459,31,21,164,490
King1278,92,67,1,1,3,7,475,30,12,159,505
King1279,101,105,0,2,7,10,571,26,19,206,597
King128,76,39,0,12,13,33,274,102,58,115,376
King1280,104,93,1,5,11,14,627,51,31,197,678
King1282,110,61,2,0,13,25,516,49,40,171,565
King1283,61,35,0,0,3,14,309,29,17,96,338
King1284,45,43,0,0,2,10,229,22,12,88,251
King1285,65,31,0,0,6,2,255,14,8,96,269
King1286,66,64,0,0,3,5,369,29,8,130,398
King1287,147,119,2,1,6,11,617,34,20,266,651
King1288,85,36,0,3,4,6,320,27,13,121,347
King129,38,39,0,3,7,17,177,46,27,77,223
King1291,150,87,2,1,2,11,576,28,16,237,604
King1292,68,57,0,1,3,11,296,25,15,125,321
King1294,104,96,1,2,7,7,602,24,17,200,626
King1295,57,71,0,0,4,4,306,13,8,128,319
King1296,62,47,1,0,1,5,263,9,7,109,272
King1297,53,25,0,0,1,4,256,9,5,78,265
King1298,82,39,1,1,4,4,286,19,10,121,305
King1299,67,42,0,3,2,8,337,20,13,109,357
King13,30,32,2,2,1,39,149,120,44,62,269
King1300,63,47,1,3,0,8,295,26,12,110,321
King1301,76,48,0,4,0,3,273,18,7,124,291
King1303,67,54,1,0,1,3,358,10,5,121,368
King1304,68,58,2,2,3,3,308,19,10,126,327
King1305,50,47,0,2,2,0,250,11,4,97,261
King1306,37,70,0,0,0,5,322,13,5,107,335
King1307,44,42,0,3,3,6,215,17,12,86,232
King1308,42,50,0,2,4,10,231,17,16,92,248
King1309,95,68,0,1,5,8,446,21,14,163,467
King131,43,40,2,1,4,25,210,68,32,83,278
King1310,62,60,0,1,6,8,308,30,15,122,338
King1311,63,57,2,3,2,6,327,23,13,120,350
King1312,45,40,0,0,7,6,257,20,13,85,277
King1313,52,46,0,1,2,7,229,18,10,98,247
King1314,50,40,0,3,0,14,262,27,17,90,289
King1317,140,79,1,6,10,20,502,60,37,219,562
King1318,102,61,0,1,7,15,442,35,23,163,477
King1319,72,70,0,2,3,7,404,21,12,142,425
King132,29,36,0,3,4,15,142,50,22,65,192
King1320,62,50,0,0,2,14,285,36,16,112,321
King1321,59,75,0,3,3,9,341,24,15,134,365
King1322,67,69,0,0,1,3,409,16,4,136,425
King1323,69,62,0,3,4,1,329,16,8,131,345
King1324,113,151,1,2,5,20,683,47,28,264,730
King1325,92,93,1,4,5,7,492,30,17,185,522
King1326,134,90,2,2,7,21,574,43,32,224,617
King1328,102,122,1,5,7,16,574,61,29,224,635
King1329,58,44,0,0,2,12,352,26,14,102,378
King133,36,40,1,3,2,19,180,46,25,76,226
King1330,60,66,0,0,2,9,326,16,11,126,342
King1331,62,64,0,0,1,5,320,18,6,126,338
King1332,60,48,0,3,0,8,320,14,11,108,334
King1333,57,36,2,2,2,7,289,13,13,93,302
King1334,62,78,0,1,5,8,362,27,14,140,389
King1335,91,81,0,0,5,10,553,27,15,172,580
King1338,98,76,0,0,2,4,381,11,6,174,392
King1339,39,45,0,2,0,5,254,13,7,84,267
King134,38,32,1,7,4,20,155,88,32,70,243
King1341,93,65,0,3,3,6,414,31,12,158,445
King1342,85,52,0,1,3,5,311,14,9,137,325
King1343,60,40,0,0,2,1,308,10,3,100,318
King1344,93,58,0,1,4,4,382,14,9,151,396
King1345,90,76,0,1,5,11,366,25,17,166,391
King1347,103,118,1,0,5,10,584,39,16,221,623
King1348,69,81,0,1,6,8,486,19,15,150,505
King1349,71,49,1,2,3,5,305,17,11,120,322
King135,20,22,2,1,4,32,131,76,39,42,207
King1350,31,40,0,0,2,1,252,9,3,71,261
King1351,90,90,1,0,3,10,514,21,14,180,535
King1352,54,90,0,1,3,10,519,25,14,144,544
King1353,48,82,0,1,1,0,411,13,2,130,424
King1354,55,82,0,0,1,7,380,16,8,137,396
King1355,54,59,0,0,2,8,350,16,10,113,366
King1357,52,37,0,0,4,2,268,16,6,89,284
King1358,49,73,0,1,0,7,355,22,8,122,377
King1359,45,93,1,1,4,4,425,26,10,138,451
King136,28,32,1,4,2,20,136,51,27,60,187
King1360,139,96,0,5,10,3,670,33,18,235,703
King1361,54,63,0,0,0,4,339,9,4,117,348
King1362,72,108,1,1,3,3,634,24,8,180,658
King1363,98,114,1,0,11,11,708,36,23,212,744
King1364,73,78,0,2,4,8,428,32,14,151,460
King1365,87,78,0,0,6,3,459,31,9,165,490
King1366,42,25,0,0,4,4,243,14,8,67,257
King1367,59,42,0,1,5,6,326,14,12,101,340
King1368,39,36,0,0,3,2,276,9,5,75,285
King1369,52,43,0,2,3,6,243,18,11,95,261
King1370,61,43,0,0,2,1,267,5,3,104,272
King1371,48,37,1,0,1,2,237,20,4,85,257
King1372,75,46,0,0,2,2,293,6,4,121,299
King1373,81,40,5,1,1,6,276,18,13,121,294
King1374,55,31,2,0,5,6,272,20,13,86,292
King1375,67,52,0,1,2,5,299,15,8,119,314
King1376,85,64,0,0,4,14,451,33,18,149,484
King1377,67,53,0,0,3,4,290,11,7,120,301
King1378,60,41,0,0,0,1,254,3,1,101,257
King1379,59,29,0,1,2,4,229,2,7,88,231
King138,48,35,2,2,5,23,187,71,32,83,258
King1380,60,39,0,0,2,6,232,11,8,99,243
King1382,66,75,0,2,2,7,320,27,11,141,347
King1384,59,41,0,4,3,16,260,26,23,100,286
King1385,40,36,0,1,3,8,234,26,12,76,260
King1386,54,38,0,2,6,21,239,34,29,92,273
King1387,78,42,1,0,11,27,327,60,39,120,387
King1388,79,55,0,0,5,4,288,13,9,134,301
King1389,44,34,0,0,3,6,207,11,9,78,218
King1390,57,53,0,0,1,2,277,10,3,110,287
King1391,58,61,0,1,4,11,341,28,16,119,369
King1392,71,69,0,2,0,4,347,17,6,140,364
King1393,56,62,0,0,2,7,254,20,9,118,274
King1394,80,92,0,1,7,8,560,34,16,172,594
King1395,61,88,0,0,4,4,386,16,8,149,402
King1396,48,37,0,1,2,7,220,21,10,85,241
King1397,60,45,0,1,6,1,296,8,8,105,304
King1398,72,71,1,3,3,11,398,31,18,143,429
King1399,69,48,0,0,6,10,253,18,16,117,271
King14,31,57,2,3,4,48,182,138,57,88,320
King140,55,33,0,6,8,25,212,78,39,88,290
King1400,68,48,0,3,2,9,321,32,14,116,353
King1401,65,104,0,3,1,9,527,40,13,169,567
King1402,55,51,0,1,1,6,275,27,8,106,302
King1403,42,75,0,2,2,11,379,31,15,117,410
King1404,56,60,0,1,1,13,313,29,15,116,342
King1406,98,40,2,5,15,11,302,33,33,138,335
King1408,176,51,2,5,28,87,488,167,122,227,655
King1409,87,44,0,3,10,26,306,56,39,131,362
King1410,53,19,0,2,5,9,176,33,16,72,209
King1411,47,30,0,1,8,18,233,49,27,77,282
King1412,43,18,0,2,5,8,188,43,15,61,231
King1413,81,68,3,0,6,34,381,68,43,149,449
King1414,49,26,0,0,7,15,152,38,22,75,190
King1415,65,55,0,0,1,12,327,31,13,120,358
King1416,65,48,1,0,2,7,288,58,10,113,346
King1418,55,42,0,0,4,12,234,25,16,97,259
King1419,123,65,0,9,24,19,483,80,52,188,563
King142,31,32,1,0,7,16,156,51,24,63,207
King1420,111,80,6,1,7,24,542,64,38,191,606
King1422,65,47,1,3,7,6,287,24,17,112,311
King1423,51,39,1,4,4,12,263,35,21,90,298
King1424,65,70,2,4,7,12,332,38,25,135,370
King1425,56,41,1,1,3,6,251,21,11,97,272
King1426,54,19,1,2,7,15,232,31,25,73,263
King1427,43,32,0,1,1,23,179,43,25,75,222
King1428,44,17,0,4,4,14,179,33,22,61,212
King1429,48,41,0,0,3,4,190,26,7,89,216
King143,40,35,4,5,5,21,146,73,35,75,219
King1430,56,23,0,0,1,12,235,35,13,79,270
King1431,63,43,1,1,1,15,241,35,18,106,276
King1432,64,42,1,1,4,16,249,39,22,106,288
King1433,69,35,1,0,4,16,252,21,21,104,273
King1434,58,25,1,1,8,9,213,31,19,83,244
King1435,52,33,0,1,6,11,217,36,18,85,253
King1436,38,59,1,0,1,5,240,28,7,97,268
King1437,58,74,0,4,4,21,388,50,29,132,438
King1438,72,43,0,0,6,19,217,54,25,115,271
King1439,53,46,0,2,8,30,245,61,40,99,306
King144,38,24,0,8,6,18,175,58,32,62,233
King1440,40,23,4,0,1,12,173,30,17,63,203
King1441,56,30,1,2,5,21,224,35,29,86,259
King1442,81,30,0,1,3,23,255,52,27,111,307
King1443,84,23,0,5,8,23,252,70,36,107,322
King1444,99,69,5,0,9,20,421,80,34,168,501
King1446,63,47,1,3,5,13,291,34,22,110,325
King1448,66,42,1,1,1,8,209,30,11,108,239
King1449,53,62,0,1,6,16,294,35,23,115,329
King145,45,39,1,3,6,19,173,45,29,84,218
King1450,53,42,0,1,8,8,245,31,17,95,276
King1451,61,45,3,1,3,16,250,33,23,106,283
King1452,53,22,0,4,1,7,219,37,12,75,256
King1453,40,30,0,3,0,7,212,26,10,70,238
King1454,56,28,0,3,8,4,229,39,15,84,268
King1455,67,82,0,2,5,13,395,39,20,149,434
King1456,71,54,3,3,2,17,307,42,25,125,349
King1457,149,138,1,5,8,31,724,91,45,287,815
King1458,83,41,0,1,10,7,321,31,18,124,352
King1459,51,33,1,1,4,13,196,34,19,84,230
King146,35,34,1,2,11,17,186,56,31,69,242
King1460,57,33,0,1,2,21,222,57,24,90,279
King1461,92,38,2,4,11,31,283,62,48,130,345
King1462,63,24,1,0,8,15,212,50,24,87,262
King1463,53,41,0,1,3,9,211,34,13,94,245
King1464,59,52,0,2,4,13,282,34,19,111,316
King1465,66,37,0,5,7,21,291,51,33,103,342
King1466,52,43,0,0,4,5,256,19,9,95,275
King1467,128,81,1,2,8,20,447,66,31,209,513
King1468,100,91,0,1,9,29,617,63,39,191,680
King1469,43,51,1,2,3,15,339,43,21,94,382
King147,60,37,2,4,5,33,242,98,44,97,340
King1470,133,86,0,6,4,19,497,73,29,219,570
King1471,73,73,0,1,6,14,380,42,21,146,422
King1472,41,34,1,2,1,12,201,29,16,75,230
King1473,47,52,0,6,1,15,240,25,22,99,265
King1474,70,62,0,0,4,13,336,33,17,132,369
King1475,51,43,0,1,3,20,242,29,24,94,271
King1476,46,41,0,0,6,5,219,19,11,87,238
King1477,43,37,2,1,4,14,232,36,21,80,268
King1478,60,22,1,0,3,11,181,34,15,82,215
King1479,68,49,1,4,1,12,245,36,18,117,281
King1480,89,107,1,0,5,19,485,57,25,196,542
King1481,68,75,0,4,5,7,334,31,16,143,365
King1482,63,49,0,1,1,6,270,23,8,112,293
King1484,58,54,0,3,6,7,250,21,16,112,271
King1485,115,71,0,4,4,21,521,45,29,186,566
King1486,49,46,1,2,1,7,251,30,11,95,281
King1487,62,56,1,3,0,10,288,29,14,118,317
King1488,81,122,1,2,2,16,560,62,21,203,622
King1489,79,92,0,2,1,16,525,57,19,171,582
King149,48,51,1,4,7,20,249,81,32,99,330
King1490,61,65,1,5,3,11,322,38,20,126,360
King1493,67,131,0,3,3,10,536,43,16,198,579
King1494,68,69,0,1,2,26,399,53,29,137,452
King1496,95,111,0,5,1,22,610,46,28,206,656
King1497,69,105,2,1,4,37,469,95,44,174,564
King1498,102,93,0,3,5,22,477,65,30,195,542
King1499,86,73,1,4,5,21,375,61,31,159,436
King1500,115,85,2,1,3,15,483,51,21,200,534
King1501,68,43,1,2,4,22,261,40,29,111,301
King1502,66,38,0,4,3,14,267,36,21,104,303
King1504,85,66,1,0,7,10,328,30,18,151,358
King1506,52,20,1,6,7,15,182,42,29,72,224
King1507,74,47,0,1,5,14,274,39,20,121,313
King1508,48,18,0,5,5,10,198,39,20,66,237
King1509,45,23,0,2,5,9,210,18,16,68,228
King151,58,35,3,5,7,23,258,69,38,93,327
King1510,69,55,0,7,4,16,300,46,27,124,346
King1511,48,55,1,1,0,14,235,32,16,103,267
King1512,28,43,0,1,1,5,207,18,7,71,225
King1513,64,85,0,4,4,19,393,66,27,149,459
King1514,77,111,3,1,8,13,379,39,25,188,418
King1515,72,70,0,1,2,6,300,32,9,142,332
King1516,68,39,0,3,3,21,294,42,27,107,336
King1517,43,33,0,1,1,5,214,21,7,76,235
King1518,46,29,0,1,6,8,194,21,15,75,215
King1519,58,30,3,4,2,14,232,38,23,88,270
King1520,47,41,1,1,9,8,233,37,19,88,270
King1521,42,30,0,1,3,18,202,43,22,72,245
King1522,64,32,0,0,2,12,199,41,14,96,240
King1523,61,26,1,0,6,11,211,45,18,87,256
King1524,53,48,0,0,4,12,225,34,16,101,259
King1526,53,36,0,0,4,16,186,29,20,89,215
King1527,99,84,0,4,7,16,470,58,27,183,528
King1529,34,37,0,3,1,15,189,40,19,71,229
King153,51,25,0,1,12,20,185,67,33,76,252
King1530,104,81,2,4,10,31,496,74,47,185,570
King1532,41,28,0,1,5,13,168,37,19,69,205
King1533,69,23,1,1,3,7,182,27,12,92,209
King1534,70,37,3,3,6,10,252,51,22,107,303
King1535,38,39,0,5,2,11,171,37,18,77,208
King1536,48,32,1,5,3,10,235,31,19,80,266
King1537,44,44,0,1,0,8,217,19,9,88,236
King1538,51,62,0,3,4,15,262,41,22,113,303
King1539,55,42,1,1,1,13,245,31,16,97,276
King154,39,8,0,0,8,24,153,59,32,47,212
King1540,46,48,1,1,0,8,227,30,10,94,257
King1541,67,43,0,4,4,19,259,64,27,110,323
King1543,73,20,2,4,10,24,212,56,40,93,268
King1545,39,72,2,0,1,16,273,51,19,111,324
King1546,84,51,0,3,5,26,284,62,34,135,346
King1550,63,79,0,2,5,11,388,37,18,142,425
King1552,30,56,1,2,1,17,235,42,21,86,277
King1553,52,44,0,3,1,18,282,41,22,96,323
King1555,62,56,0,1,5,11,305,25,17,118,330
King1557,47,26,1,0,0,17,230,39,18,73,269
King1558,91,55,4,3,3,24,450,47,34,146,497
King1559,53,33,0,4,0,7,240,12,11,86,252
King156,86,42,3,7,13,40,338,155,63,128,493
King1563,46,35,0,2,1,8,192,27,11,81,219
King1564,92,43,0,3,3,16,292,38,22,135,330
King1565,50,56,1,0,3,7,236,29,11,106,265
King1566,52,18,0,2,5,19,188,77,26,70,265
King1567,63,36,3,0,1,6,250,15,10,99,265
King1568,55,47,1,3,3,12,265,43,19,102,308
King1570,138,52,0,1,1,10,421,46,12,190,467
King1571,99,46,2,2,1,11,302,30,16,145,332
King1572,67,36,0,0,0,5,239,22,5,103,261
King1574,72,43,0,3,2,12,277,42,17,115,319
King1575,39,20,0,3,5,6,198,31,14,59,229
King1576,74,34,0,1,0,7,279,25,8,108,304
King1578,55,39,0,1,0,18,280,35,19,94,315
King1579,36,46,1,0,0,1,179,12,2,82,191
King1580,55,34,0,1,0,7,219,22,8,89,241
King1582,95,65,0,1,0,21,497,63,22,160,560
King1583,171,73,1,4,2,9,578,31,16,244,609
King1584,62,41,0,0,2,12,272,22,14,103,294
King1585,81,38,0,3,1,3,305,16,7,119,321
King1586,68,53,0,2,4,2,324,10,8,121,334
King1587,72,41,0,1,1,6,239,21,8,113,260
King1588,48,33,0,0,1,8,215,14,9,81,229
King1589,63,42,0,0,2,4,251,14,6,105,265
King159,70,47,1,7,16,30,283,107,54,117,390
King1590,70,42,1,0,4,6,258,10,11,112,268
King1591,66,53,0,0,2,8,292,16,10,119,308
King1592,127,116,2,1,4,4,856,23,11,243,879
King1593,85,63,2,0,1,3,366,6,6,148,372
King1594,130,71,0,4,0,16,610,29,20,201,639
King1596,91,67,0,1,2,16,374,37,19,158,411
King1597,126,96,1,2,4,23,552,57,30,222,609
King16,32,19,3,4,4,38,136,98,49,51,234
King160,31,20,2,3,3,26,139,64,34,51,203
King1600,83,66,1,0,1,16,378,39,18,149,417
King1602,56,105,0,0,4,15,426,42,19,161,468
King1607,75,72,0,0,0,11,358,34,11,147,392
King1608,82,82,0,2,3,11,478,18,16,164,496
King1609,66,74,0,0,0,7,330,21,7,140,351
King1610,60,39,0,0,0,6,254,14,6,99,268
King1611,60,33,0,1,0,5,238,15,6,93,253
King1612,67,35,0,1,2,9,218,20,12,102,238
King1613,89,28,0,1,2,7,273,13,10,117,286
King1614,45,34,0,0,1,1,215,12,2,79,227
King1615,58,57,0,1,2,4,280,17,7,115,297
King1616,57,44,1,2,3,6,269,20,12,101,289
King1617,40,56,3,0,1,2,233,15,6,96,248
King1618,51,45,0,0,0,3,272,21,3,96,293
King1619,65,74,0,4,1,7,342,17,12,139,359
King162,36,23,1,4,7,16,138,44,28,59,182
King1620,47,34,0,1,2,8,245,31,11,81,276
King1621,53,28,0,1,2,8,225,24,11,81,249
King1622,99,46,0,1,2,16,347,34,19,145,381
King1624,78,63,2,1,3,15,366,49,21,141,415
King1628,52,38,0,0,1,9,304,15,10,90,319
King1629,111,38,0,1,2,10,371,37,13,149,408
King163,63,37,0,1,9,27,217,75,37,100,292
King1630,30,37,0,9,6,14,178,48,29,67,226
King1631,73,15,0,3,3,15,201,38,21,88,239
King1632,53,21,0,0,1,9,212,32,10,74,244
King1633,52,38,0,2,3,6,222,30,11,90,252
King1634,72,45,3,2,5,12,299,33,22,117,332
King1635,93,63,1,0,0,9,345,28,10,156,373
King1636,97,58,0,1,1,15,354,37,17,155,391
King1637,115,57,0,6,5,14,437,48,25,172,485
King1638,53,35,0,1,0,6,310,21,7,88,331
King1639,95,49,0,1,0,18,332,49,19,144,381
King164,36,34,3,6,6,26,163,71,41,70,234
King1640,105,75,1,2,3,11,470,55,17,180,525
King1641,66,44,1,1,0,14,285,43,16,110,328
King1643,85,50,2,2,2,15,431,55,21,135,486
King1646,58,34,1,1,1,12,338,24,15,92,362
King1647,118,51,0,5,4,20,476,50,29,169,526
King1648,115,84,0,1,1,12,490,54,14,199,544
King165,63,14,1,2,11,41,199,93,55,77,292
King1650,60,32,0,0,4,8,190,26,12,92,216
King1651,104,43,0,3,1,15,443,44,19,147,487
King1652,51,20,0,6,2,12,184,40,20,71,224
King166,40,23,0,4,13,39,181,119,56,63,300
King1661,73,16,2,4,11,9,213,36,26,89,249
King1662,73,31,1,5,14,37,270,87,57,104,357
King1663,59,14,0,1,7,19,186,63,27,73,249
King1664,60,22,2,0,11,22,216,53,35,82,269
King1665,121,30,0,1,17,34,378,80,52,151,458
King1666,130,52,0,2,21,39,402,117,62,182,519
King1668,68,58,0,2,5,23,310,57,30,126,367
King167,49,19,1,8,1,20,164,59,30,68,223
King1670,109,48,0,0,14,29,364,64,43,157,428
King1672,52,17,1,1,8,16,176,37,26,69,213
King1673,142,78,0,3,24,46,548,133,73,220,681
King1675,58,19,1,5,4,16,204,58,26,77,262
King1676,54,16,0,0,8,19,179,45,27,70,224
King1677,56,25,0,2,16,23,229,71,41,81,300
King1679,91,27,0,4,13,20,301,55,37,118,356
King168,36,28,0,3,6,18,155,41,27,64,196
King1682,66,21,1,0,3,26,209,47,30,87,256
King1683,56,22,0,2,6,19,214,51,27,78,265
King1684,53,48,1,4,1,7,234,39,13,101,273
King1685,65,61,1,2,2,3,338,25,8,126,363
King1686,23,36,0,2,1,5,182,11,8,59,193
King1687,96,116,1,4,16,18,489,67,39,212,556
King1688,40,32,0,6,5,14,180,42,25,72,222
King1689,95,61,0,2,12,24,358,56,38,156,414
King169,59,34,0,4,5,32,196,85,41,93,281
King1690,49,25,0,3,2,14,241,43,19,74,284
King1691,48,35,0,2,2,14,229,24,18,83,253
King1692,53,29,1,7,10,11,271,52,29,82,323
King1693,86,19,2,3,8,15,261,43,28,105,304
King1695,105,38,0,1,10,29,340,63,40,143,403
King1696,81,23,1,4,9,40,286,73,54,104,359
King1697,51,46,1,4,2,18,227,36,25,97,263
King1698,60,20,0,1,3,15,222,33,19,80,255
King1699,46,43,1,0,2,10,199,39,13,89,238
King17,81,57,0,5,5,35,321,114,45,138,435
King170,34,21,1,4,2,20,124,47,27,55,171
King1700,65,31,0,0,1,12,274,42,13,96,316
King1701,72,47,0,0,3,17,265,30,20,119,295
King1702,110,58,1,3,11,24,433,65,39,168,498
King1703,98,62,2,2,6,27,414,64,37,160,478
King1704,84,64,0,3,3,9,467,45,15,148,512
King1709,29,58,0,1,3,11,267,26,15,87,293
King171,45,59,3,4,7,33,223,99,47,104,322
King1710,33,46,0,2,4,8,268,35,14,79,303
King1711,107,93,0,0,11,28,633,61,39,200,694
King1712,81,64,1,1,3,14,381,35,19,145,416
King1713,49,43,1,2,2,6,265,19,11,92,284
King1714,96,72,2,2,1,14,397,33,19,168,430
King1715,39,64,0,0,4,6,300,16,10,103,316
King1716,46,65,0,1,2,3,282,14,6,111,296
King1717,52,29,0,1,2,12,175,25,15,81,200
King1718,40,28,0,2,4,6,246,18,12,68,264
King1719,101,57,1,2,10,12,384,48,25,158,432
King1720,71,85,0,1,6,12,436,44,19,156,480
King1721,79,69,0,1,5,11,376,30,17,148,406
King1722,68,75,0,4,7,13,404,41,24,143,445
King1723,85,43,0,4,9,11,316,31,24,128,347
King1724,79,29,0,3,7,19,249,45,29,108,294
King1725,65,45,0,2,1,4,320,18,7,110,338
King1726,68,50,1,3,2,8,304,23,14,118,327
King1727,74,35,0,3,9,13,282,28,25,109,310
King1729,36,26,0,0,1,7,183,11,8,62,194
King1730,89,31,1,3,2,14,294,26,20,120,320
King1731,83,50,1,4,1,5,318,33,11,133,351
King1732,97,51,0,1,5,14,355,42,20,148,397
King1734,100,67,0,0,4,12,371,39,16,167,410
King1735,55,17,0,1,3,4,202,15,8,72,217
King1736,71,36,1,1,4,10,250,34,16,107,284
King1737,62,48,0,2,5,12,333,29,19,110,362
King1738,80,24,1,0,1,12,231,23,14,104,254
King1739,87,24,0,0,3,7,248,20,10,111,268
King1740,70,29,1,1,4,6,266,21,12,99,287
King1741,48,47,0,1,2,13,277,21,16,95,298
King1742,60,26,0,0,7,7,272,29,14,86,301
King1743,77,31,0,1,5,10,311,33,16,108,344
King1744,89,42,0,0,4,6,345,21,10,131,366
King1746,51,32,0,0,2,3,240,23,5,83,263
King1747,80,26,0,0,4,5,251,15,9,106,266
King1748,50,33,0,0,3,8,248,17,11,83,265
King1749,94,117,0,5,8,19,541,49,32,211,590
King175,125,83,6,11,14,60,481,173,91,208,654
King1750,98,58,1,0,6,10,426,26,17,156,452
King1751,73,47,0,0,5,7,297,24,12,120,321
King1752,73,49,0,1,4,12,352,26,17,122,378
King1754,81,47,0,1,1,12,307,30,14,128,337
King1755,67,19,0,0,2,5,227,13,7,86,240
King1756,113,104,0,3,11,39,544,81,53,217,625
King1757,57,34,0,4,0,6,209,23,10,91,232
King1758,69,34,1,4,7,17,289,25,29,103,314
King1759,39,33,2,0,2,8,220,19,12,72,239
King176,92,48,1,4,5,51,328,119,61,140,447
King1760,72,31,0,1,0,6,259,24,7,103,283
King1761,55,25,0,2,2,8,238,34,12,80,272
King1762,72,24,0,2,1,7,250,28,10,96,278
King1763,59,36,2,2,2,7,250,17,13,95,267
King1764,70,18,0,0,4,7,216,13,11,88,229
King1765,55,24,0,1,0,2,203,14,3,79,217
King1766,73,42,0,0,2,5,316,27,7,115,343
King1767,54,101,1,3,4,20,434,42,28,155,476
King1768,58,31,0,1,4,12,248,40,17,89,288
King1769,45,25,0,1,1,10,182,21,12,70,203
King177,68,37,0,3,10,32,224,79,45,105,303
King1770,62,16,0,0,8,8,195,12,16,78,207
King1771,70,63,1,1,6,28,360,47,36,133,407
King1772,102,62,1,2,11,23,413,66,37,164,479
King1773,103,57,0,6,6,20,424,59,32,160,483
King1774,105,44,0,2,14,26,332,69,42,149,401
King1775,116,82,0,5,6,34,543,75,45,198,618
King1776,151,59,0,3,12,32,442,73,47,210,515
King1779,35,73,1,1,2,6,343,23,10,108,366
King178,27,40,0,4,2,14,216,50,20,67,266
King1780,71,60,1,1,4,22,316,42,28,131,358
King1781,53,46,0,3,1,7,210,28,11,99,238
King1783,63,49,0,0,3,11,354,21,14,112,375
King1784,116,62,1,1,5,14,449,32,21,178,481
King1787,49,53,0,1,1,5,362,26,7,102,388
King1788,283,97,1,5,18,19,587,33,43,380,620
King179,45,26,0,7,7,19,162,64,33,71,226
King180,37,21,0,6,7,18,174,67,31,58,241
King1801,113,55,0,0,10,24,698,67,34,168,765
King1803,46,31,0,1,6,13,224,32,20,77,256
King1805,50,58,0,2,9,9,358,40,20,108,398
King1806,57,90,0,0,5,10,482,40,15,147,522
King1808,39,40,0,1,1,4,231,15,6,79,246
King1812,81,41,0,0,10,16,324,44,26,122,368
King1813,32,41,0,2,0,11,215,26,13,73,241
King1815,92,54,0,2,2,20,359,42,24,146,401
King1816,67,39,0,1,4,8,233,28,13,106,261
King1817,48,18,0,1,9,5,185,20,15,66,205
King1818,65,9,0,1,34,38,169,78,73,74,247
King1819,111,23,2,1,18,30,323,69,51,134,392
King1821,55,8,0,0,9,8,169,24,17,63,193
King1823,16,5,0,1,0,5,82,17,6,21,99
King1824,79,61,0,2,2,5,330,12,9,140,342
King1825,127,79,1,0,2,31,507,80,34,206,587
King1826,115,73,0,1,2,10,468,18,13,188,486
King1827,107,77,3,2,4,17,438,26,26,184,464
King1831,59,51,0,0,4,3,302,20,7,110,322
King1833,106,81,0,0,2,8,536,32,10,187,568
King1834,49,62,0,0,1,3,325,14,4,111,339
King1835,169,92,1,6,22,30,534,68,59,261,602
King1838,99,96,0,2,1,6,596,32,9,195,628
King1839,109,137,2,0,2,9,636,18,13,246,654
King1840,97,77,0,4,1,11,464,44,16,174,508
King1841,89,145,0,2,2,8,631,34,12,234,665
King1842,108,64,0,2,1,6,416,20,9,172,436
King1843,71,125,0,0,4,4,710,38,8,196,748
King1845,76,73,0,1,3,4,461,23,8,149,484
King1846,24,66,0,0,2,2,281,7,4,90,288
King1847,50,77,0,1,0,8,500,15,9,127,515
King1849,39,52,0,0,0,4,267,5,4,91,272
King1850,85,117,2,3,2,14,493,46,21,202,539
King1851,96,84,0,0,1,12,562,22,13,180,584
King1853,51,29,0,1,0,5,226,11,6,80,237
King1854,63,42,0,1,0,8,283,24,9,105,307
King1855,85,99,0,2,6,2,554,14,10,184,568
King1856,101,101,2,1,3,8,462,20,14,202,482
King1857,62,84,0,1,1,3,482,12,5,146,494
King1858,55,59,0,0,3,2,322,6,5,114,328
King1859,70,87,0,2,2,4,485,10,8,157,495
King186,29,18,0,4,8,19,152,51,31,47,203
King1860,93,92,0,0,4,10,770,24,14,185,794
King1861,125,134,1,1,4,2,664,17,8,259,681
King1862,58,70,0,3,1,7,363,18,11,128,381
King1863,71,63,0,1,1,4,404,10,6,134,414
King1864,96,58,0,3,3,28,351,44,34,154,395
King1867,96,132,0,3,2,7,736,22,12,228,758
King1868,68,45,0,0,2,1,336,10,3,113,346
King1869,63,85,1,0,0,7,399,16,8,148,415
King1870,101,77,0,1,4,3,482,11,8,178,493
King1871,142,80,1,0,2,1,515,12,4,222,527
King1872,127,58,1,1,5,22,464,44,29,185,508
King1874,87,111,0,1,1,9,565,27,11,198,592
King1875,85,88,0,0,0,14,425,24,14,173,449
King1876,101,126,1,0,3,2,642,22,6,227,664
King1879,65,69,0,1,0,4,404,10,5,134,414
King188,62,30,1,5,9,23,276,94,38,92,370
King1880,66,81,0,3,1,2,403,13,6,147,416
King1881,55,60,0,0,2,2,387,10,4,115,397
King1882,63,67,1,0,3,3,354,8,7,130,362
King1883,51,54,1,0,0,6,358,12,7,105,370
King1884,93,89,0,2,3,4,559,14,9,182,573
King1885,64,58,0,1,4,1,368,8,6,122,376
King1886,90,81,0,1,2,1,545,16,4,171,561
King1887,101,89,0,2,2,11,540,25,15,190,565
King1888,88,77,0,2,4,3,525,15,9,165,540
King1889,82,71,0,0,1,7,400,15,8,153,415
King189,53,51,0,5,3,28,281,110,36,104,391
King1890,149,41,1,0,7,7,495,31,15,190,526
King1891,60,21,0,0,2,4,254,11,6,81,265
King1892,103,73,0,2,2,5,566,18,9,176,584
King1893,88,57,0,3,1,2,373,13,6,145,386
King1894,86,49,0,0,1,1,383,9,2,135,392
King1895,118,77,0,0,2,4,530,17,6,195,547
King1896,97,43,0,0,1,2,358,7,3,140,365
King1897,49,97,1,1,0,10,464,34,12,146,498
King1898,40,40,0,0,1,1,240,1,2,80,241
King1899,56,42,0,0,0,1,291,7,1,98,298
King19,90,55,0,19,11,69,416,159,99,145,575
King190,35,45,5,7,5,15,245,65,32,80,310
King1900,77,52,0,0,0,2,287,8,2,129,295
King1901,57,42,0,0,0,3,229,5,3,99,234
King1902,63,44,0,0,0,4,264,8,4,107,272
King1903,72,29,0,0,3,8,257,16,11,101,273
King1906,96,48,0,0,1,1,361,7,2,144,368
King1907,143,97,2,0,3,8,597,23,13,240,620
King191,39,14,1,0,8,22,159,56,31,53,215
King1910,118,58,1,2,2,4,446,11,9,176,457
King1911,65,15,0,0,1,10,203,24,11,80,227
King1913,87,33,0,1,2,3,294,9,6,120,303
King1914,120,42,0,0,4,9,470,15,13,162,485
King1915,107,26,0,1,4,11,365,27,16,133,392
King1916,113,21,1,0,5,3,292,16,9,134,308
King1917,116,48,1,1,6,8,359,26,16,164,385
King1918,73,22,0,2,2,7,292,15,11,95,307
King1919,65,35,0,1,3,20,272,34,24,100,306
King192,60,19,1,3,15,30,181,79,49,79,260
King1920,117,59,0,0,4,17,463,38,21,176,501
King1925,45,42,0,4,1,13,183,27,18,87,210
King1927,55,74,0,0,1,12,328,20,13,129,348
King1928,24,60,0,0,2,6,218,21,8,84,239
King193,55,47,0,9,6,28,238,79,43,102,317
King1930,126,120,2,1,1,15,626,34,19,246,660
King1932,95,59,0,0,0,5,327,19,5,154,346
King1934,183,90,0,2,3,21,617,41,26,273,658
King1935,66,39,1,0,0,0,255,6,1,105,261
King1936,81,18,0,1,3,5,238,18,9,99,256
King1937,66,29,1,1,6,11,237,25,19,95,262
King1938,75,50,0,0,1,1,290,5,2,125,295
King194,50,18,3,3,7,15,160,49,28,68,209
King1940,84,81,0,0,4,6,410,15,10,165,425
King1941,67,76,0,0,0,11,322,32,11,143,354
King1942,78,65,1,1,0,12,397,35,14,143,432
King1944,120,71,0,0,3,12,561,27,15,191,588
King1945,127,75,0,3,1,28,499,59,32,202,558
King1947,80,76,0,2,2,11,405,43,15,156,448
King1950,17,11,1,0,0,10,88,23,11,28,111
King1952,55,15,0,1,4,4,220,15,9,70,235
King1953,51,16,0,0,5,6,175,14,11,67,189
King1954,64,12,0,2,9,11,214,23,22,76,237
King1955,70,96,1,4,6,9,439,50,20,166,489
King1957,88,28,1,4,24,38,320,97,67,116,417
King1959,137,61,0,5,12,35,522,95,52,198,617
King196,39,18,1,0,10,38,154,95,49,57,249
King1961,73,27,1,1,5,10,215,19,17,100,234
King1962,63,24,0,0,7,9,232,29,16,87,261
King1963,51,34,0,1,4,6,208,18,11,85,226
King1964,62,70,0,3,1,4,402,33,8,132,435
King1965,69,35,1,1,0,1,245,9,3,104,254
King1966,49,40,0,0,2,3,220,16,5,89,236
King1967,101,64,2,2,5,9,355,39,18,165,394
King1968,46,37,0,4,4,7,215,19,15,83,234
King1969,38,18,0,0,5,11,211,27,16,56,238
King1970,44,12,0,0,7,11,178,28,18,56,206
King1971,77,19,0,2,14,16,232,45,32,96,277
King1974,87,32,1,2,12,17,305,48,32,119,353
King1975,7,13,0,0,1,3,112,16,4,20,128
King1976,6,27,0,2,0,6,222,21,8,33,243
King1977,61,21,0,2,11,21,225,48,34,82,273
King1978,102,24,0,0,16,14,348,64,30,126,412
King198,122,49,0,3,29,79,462,197,111,171,659
King1980,78,15,0,3,13,16,244,47,32,93,291
King1982,79,61,0,3,3,7,458,21,13,140,479
King1983,117,43,2,3,13,15,388,37,33,160,425
King1986,59,20,0,0,1,5,199,13,6,79,212
King1990,103,43,1,0,9,21,370,53,31,146,423
King1991,171,82,2,2,17,38,610,111,59,253,721
King1992,85,23,2,3,35,67,350,152,107,108,502
King1993,61,15,0,0,1,5,200,16,6,76,216
King1994,65,26,0,1,1,5,241,12,7,91,253
King1995,59,22,0,0,2,5,196,10,7,81,206
King1996,71,22,0,2,6,5,257,20,13,93,277
King1997,52,33,0,3,2,17,217,38,22,85,255
King1999,91,60,0,0,6,9,378,17,15,151,395
King2000,68,85,0,0,5,9,431,24,14,153,455
King2001,142,71,0,5,6,16,513,51,27,213,564
King2002,134,89,0,2,4,5,564,28,11,223,592
King2004,49,49,0,0,0,5,286,16,5,98,302
King2006,53,24,0,1,4,11,199,37,16,77,236
King2007,54,19,0,0,4,8,201,20,12,73,221
King2008,67,24,0,0,4,6,208,17,10,91,225
King2009,114,65,0,0,3,9,427,23,12,179,450
King201,64,26,2,2,29,50,253,142,83,90,395
King2011,68,17,1,0,4,6,213,18,11,85,231
King2013,70,35,0,1,1,4,274,13,6,105,287
King2014,73,34,0,1,4,8,290,16,13,107,306
King2015,72,20,0,0,8,10,249,37,18,92,286
King2016,51,50,0,1,0,2,296,4,3,101,300
King2017,71,57,0,0,0,2,361,11,2,128,372
King2018,98,86,0,0,2,8,518,22,10,184,540
King2020,81,36,0,0,2,4,326,28,6,117,354
King2021,155,102,0,4,4,11,690,30,19,257,720
King2023,64,51,1,0,2,5,293,29,8,115,322
King2024,50,43,0,0,3,2,258,6,5,93,264
King2025,107,55,0,0,6,8,458,14,14,162,472
King2026,89,24,0,1,2,5,318,25,8,113,343
King2027,60,31,0,0,3,7,242,13,10,91,255
King2028,125,44,0,1,2,8,367,18,11,169,385
King2029,193,64,0,1,8,9,613,35,18,257,648
King203,122,45,3,2,26,69,375,178,100,167,553
King2033,119,47,1,1,11,8,375,30,21,166,405
King2034,85,59,0,2,3,5,360,24,10,144,384
King2035,93,76,0,3,2,9,537,43,14,169,580
King2037,83,73,0,0,2,6,529,13,8,156,542
King2038,115,74,0,0,4,10,487,17,14,189,504
King2039,45,56,0,0,3,6,285,26,9,101,311
King2040,61,79,0,0,3,1,447,12,4,140,459
King2043,49,42,0,0,1,4,261,10,5,91,271
King2044,58,42,0,0,4,6,277,12,10,100,289
King2045,35,45,1,0,4,9,255,15,14,80,270
King2047,106,125,0,1,5,16,598,31,22,231,629
King2048,39,56,3,0,1,6,298,20,10,95,318
King2049,38,70,0,0,8,1,350,17,9,108,367
King205,34,23,1,2,17,44,157,90,64,57,247
King2050,67,59,0,0,10,12,366,27,22,126,393
King2052,19,67,0,0,1,6,294,20,7,86,314
King2055,20,45,0,2,1,3,276,19,6,65,295
King2056,72,50,1,1,8,8,252,20,18,122,272
King2057,106,28,0,1,10,20,344,35,31,134,379
King2058,57,10,0,2,5,8,176,44,15,67,220
King2059,75,67,0,3,2,10,373,12,15,142,385
King206,123,48,4,3,15,56,525,178,78,171,703
King2061,59,51,1,0,2,6,376,17,9,110,393
King2064,38,62,1,2,4,4,257,11,11,100,268
King2065,60,92,0,4,0,16,433,44,20,152,477
King2068,34,70,0,1,1,11,314,21,13,104,335
King2069,119,83,0,1,4,10,565,30,15,202,595
King207,39,27,3,4,10,24,181,66,41,66,247
King2071,95,39,0,0,3,2,317,10,5,134,327
King2074,72,69,0,2,3,3,435,23,8,141,458
King2075,29,37,1,2,6,7,234,34,16,66,268
King2076,28,37,0,1,1,6,208,29,8,65,237
King2081,6,14,1,0,1,6,157,26,8,20,183
King2083,58,48,0,2,4,2,318,15,8,106,333
King2084,124,84,3,3,8,13,547,42,27,208,589
King2088,94,104,1,1,9,13,492,42,24,198,534
King2089,8,29,0,1,1,4,160,14,6,37,174
King2090,68,59,0,2,2,2,361,23,6,127,384
King2091,57,43,2,2,5,6,360,21,15,100,381
King2092,87,35,1,2,3,4,273,10,10,122,283
King2093,102,62,0,0,5,7,409,16,12,164,425
King2094,53,29,2,0,0,3,225,11,5,82,236
King2095,65,22,0,2,3,3,231,16,8,87,247
King2096,64,27,0,0,6,4,197,8,10,91,205
King2097,71,41,0,5,4,3,320,19,12,112,339
King2098,100,52,0,5,7,6,350,22,18,152,372
King2099,101,46,1,2,6,12,352,34,21,147,386
King210,42,30,2,0,8,43,187,77,53,72,264
King2100,74,40,0,2,3,8,315,19,13,114,334
King2104,79,42,0,0,3,1,348,21,4,121,369
King2105,107,73,2,0,7,12,481,41,21,180,522
King2109,23,70,1,1,6,4,349,28,12,93,377
King211,57,29,1,3,12,31,213,71,47,86,284
King2110,47,67,0,1,2,4,349,8,7,114,357
King2113,30,51,0,0,0,2,334,23,2,81,357
King2115,17,73,0,1,5,1,575,48,7,90,623
King2116,51,34,0,2,0,3,267,13,5,85,280
King2117,61,64,0,0,3,6,277,18,9,125,295
King2118,71,54,0,1,7,12,329,18,20,125,347
King2119,58,47,0,1,1,5,259,18,7,105,277
King212,106,81,0,8,15,49,320,131,72,187,451
King2120,86,62,0,2,0,4,348,17,6,148,365
King2121,48,82,0,0,3,10,377,25,13,130,402
King2125,93,115,3,1,3,21,461,53,28,208,514
King2126,98,132,0,5,5,21,553,51,31,230,604
King2127,96,70,1,3,8,20,348,56,32,166,404
King2128,59,87,3,8,6,15,405,44,32,146,449
King2129,91,107,0,5,4,8,539,47,17,198,586
King213,46,43,0,5,3,27,220,77,35,89,297
King2130,74,67,0,0,3,10,317,22,13,141,339
King2131,108,112,0,2,5,19,639,79,26,220,718
King2133,89,124,1,1,3,18,583,47,23,213,630
King2134,55,86,2,3,1,9,393,32,15,141,425
King214,62,22,2,6,1,27,153,54,36,84,207
King2142,126,98,1,7,9,16,471,68,33,224,539
King2143,55,41,1,0,4,12,191,38,17,96,229
King2145,63,47,2,5,14,19,347,58,40,110,405
King2146,52,45,1,0,3,7,285,13,11,97,298
King2147,92,66,0,0,4,14,422,27,18,158,449
King2148,55,54,0,0,2,7,302,22,9,109,324
King2149,68,49,0,1,2,12,307,19,15,117,326
King2152,42,71,0,6,4,10,258,37,20,113,295
King2153,50,73,0,3,3,14,321,50,20,123,371
King216,34,28,2,10,5,23,201,83,40,62,284
King2161,83,56,1,2,3,7,391,21,13,139,412
King2162,60,44,0,1,2,6,306,22,9,104,328
King2163,53,23,1,1,4,3,227,16,9,76,243
King2164,63,54,2,2,6,1,283,17,11,117,300
King2165,47,36,0,2,0,7,209,12,9,83,221
King2166,57,58,0,0,3,4,290,15,7,115,305
King2167,65,43,0,4,1,3,240,38,8,108,278
King2168,86,78,0,1,3,5,459,25,9,164,484
King217,50,38,1,5,9,29,243,84,44,88,327
King2170,87,51,2,1,5,7,361,30,15,138,391
King2171,100,53,2,4,8,9,378,54,23,153,432
King2172,75,49,0,2,2,8,253,20,12,124,273
King218,74,47,0,11,20,46,302,115,77,121,417
King219,71,67,1,9,5,41,352,109,56,138,461
King22,97,71,0,6,4,30,423,79,40,168,502
King220,57,19,0,11,15,38,221,92,64,76,313
King2200,66,48,1,2,7,24,288,41,34,114,329
King2201,111,44,0,3,8,14,351,52,25,155,403
King2202,79,47,0,6,5,15,325,47,26,126,372
King2203,106,132,0,10,4,23,512,72,37,238,584
King2204,57,49,1,3,5,9,240,29,18,106,269
King2206,71,46,0,6,1,8,313,42,15,117,355
King2208,73,30,0,3,3,9,276,26,15,103,302
King2209,123,55,0,7,10,42,415,84,59,178,499
King221,81,39,4,7,13,52,315,155,76,120,470
King2210,163,44,6,10,7,28,416,81,51,207,497
King2211,84,88,5,3,1,21,414,69,30,172,483
King2215,162,84,2,4,14,51,583,102,71,246,685
King2216,60,56,2,2,6,19,260,38,29,116,298
King2217,161,91,0,5,4,44,494,100,53,252,594
King2218,89,112,3,4,4,29,470,67,40,201,537
King2221,80,74,0,1,1,15,377,53,17,154,430
King2224,85,72,1,1,5,17,395,54,24,157,449
King2228,70,60,0,1,2,8,323,38,11,130,361
King223,66,20,0,1,14,29,254,80,44,86,334
King2231,87,55,1,2,9,11,475,54,23,142,529
King2234,57,26,0,3,3,6,229,18,12,83,247
King2236,57,48,2,0,5,7,311,26,14,105,337
King2237,102,82,0,4,8,13,457,33,25,184,490
King2238,162,109,0,1,8,16,675,35,25,271,710
King2239,107,74,2,5,3,9,455,38,19,181,493
King224,89,43,2,5,16,50,379,122,73,132,501
King2240,101,45,0,0,3,10,372,18,13,146,390
King2243,96,38,0,5,2,21,363,46,28,134,409
King2244,72,31,0,1,6,3,234,10,10,103,244
King2245,117,41,0,3,6,18,341,37,27,158,378
King2247,141,66,1,3,12,13,496,45,29,207,541
King2249,44,7,0,3,5,10,184,28,18,51,212
King225,61,28,0,5,13,51,222,114,69,89,336
King2251,91,58,1,5,3,18,414,47,27,149,461
King2252,43,26,0,2,4,5,212,20,11,69,232
King2253,88,50,0,1,6,10,394,41,17,138,435
King2257,125,115,1,4,11,12,650,56,28,240,706
King226,44,17,0,3,14,31,177,72,48,61,249
King2260,127,104,1,5,9,18,598,43,33,231,641
King2261,48,30,0,3,2,7,215,22,12,78,237
King2263,119,73,0,4,13,12,485,37,29,192,522
King2264,151,94,0,1,2,15,609,36,18,245,645
King2266,60,25,1,0,18,29,308,82,48,85,390
King2267,68,96,0,4,5,12,398,31,21,164,429
King2268,64,25,0,1,2,12,235,33,15,89,268
King2269,55,34,0,0,7,3,249,12,10,89,261
King227,81,70,1,9,16,41,367,98,67,151,465
King2270,61,37,0,0,5,7,241,13,12,98,254
King2271,89,41,5,0,10,10,402,37,25,130,439
King2272,87,33,1,3,6,16,273,35,26,120,308
King2274,51,32,0,0,1,10,230,20,11,83,250
King2275,14,32,0,1,1,3,93,18,5,46,111
King2276,62,54,0,0,1,13,303,24,14,116,327
King2277,110,69,0,0,4,12,436,27,16,179,463
King2280,139,97,0,1,7,15,513,43,23,236,556
King2282,107,84,1,3,10,13,523,52,27,191,575
King2283,48,35,0,2,2,4,284,14,8,83,298
King2285,75,34,1,2,2,3,239,16,8,109,255
King2286,81,57,0,5,5,5,339,42,15,138,381
King2289,54,38,0,2,3,7,254,21,12,92,275
King229,86,46,0,11,10,70,334,183,91,132,517
King2290,51,32,1,0,3,6,229,21,10,83,250
King2291,62,61,0,4,2,9,319,22,15,123,341
King2292,88,68,0,3,6,5,411,30,14,156,441
King2293,71,58,1,0,7,13,352,26,21,129,378
King2295,82,59,1,3,2,11,425,30,17,141,455
King2296,60,43,0,5,4,15,278,35,24,103,313
King2297,56,36,0,4,2,11,225,18,17,92,243
King2298,70,48,0,2,3,5,248,18,10,118,266
King2299,70,65,0,4,1,4,321,14,9,135,335
King2300,94,68,1,5,7,13,407,39,26,162,446
King2302,79,38,0,2,5,13,308,30,20,117,338
King2303,74,50,0,0,2,12,338,37,14,124,375
King2304,63,40,0,1,6,7,281,26,14,103,307
King2305,73,46,0,2,6,14,277,34,22,119,311
King2306,51,34,2,1,2,8,228,31,13,85,259
King2307,69,32,0,0,2,4,247,18,6,101,265
King2308,53,62,0,3,3,9,284,31,15,115,315
King2309,53,49,0,0,5,6,240,30,11,102,270
King231,74,65,1,4,2,30,343,79,37,139,422
King2310,99,50,0,4,5,16,318,25,25,149,343
King2311,63,70,1,1,4,11,339,36,17,133,375
King2313,97,91,1,3,5,20,395,56,29,188,451
King2314,60,55,1,1,0,9,262,23,11,115,285
King2316,79,68,0,0,5,6,334,23,11,147,357
King2317,72,62,1,2,2,11,328,35,16,134,363
King2318,67,31,0,0,2,5,232,17,7,98,249
King2319,91,58,2,6,1,27,349,65,36,149,414
King232,72,65,0,3,4,20,277,55,27,137,332
King2320,70,34,1,3,6,19,250,56,29,104,306
King2321,67,48,0,1,2,7,281,18,10,115,299
King2322,80,85,2,0,4,10,362,31,16,165,393
King2323,107,95,0,1,4,16,419,42,21,202,461
King2324,68,67,1,4,1,8,303,41,14,135,344
King2325,95,54,1,6,6,37,237,72,50,149,309
King2326,80,66,4,3,4,11,359,67,22,146,426
King2327,61,45,1,0,5,11,236,35,17,106,271
King2328,37,40,1,4,5,14,234,43,24,77,277
King233,106,65,0,2,2,20,474,52,24,171,526
King2330,69,46,2,5,4,7,316,24,18,115,340
King2332,48,39,0,4,1,8,198,39,13,87,237
King2333,58,35,0,0,2,18,272,38,20,93,310
King2334,72,106,2,5,6,20,403,65,33,178,468
King2335,71,107,0,1,3,16,406,62,20,178,468
King2336,96,87,0,4,2,20,516,60,26,183,576
King2337,50,58,0,3,1,12,259,40,16,108,299
King2338,79,89,0,5,1,14,404,39,20,168,443
King2339,46,52,2,2,4,13,206,40,21,98,246
King2340,104,99,1,5,6,29,456,69,41,203,525
King2341,93,86,4,5,5,21,397,60,35,179,457
King2342,54,48,1,3,4,12,272,46,20,102,318
King2343,56,46,1,1,6,11,240,38,19,102,278
King2344,113,91,1,6,3,20,563,66,30,204,629
King2345,60,18,2,3,6,10,237,33,21,78,270
King2346,65,46,0,3,4,8,281,24,15,111,305
King2347,65,72,2,2,1,23,392,54,28,137,446
King2348,34,49,0,0,4,12,198,24,16,83,222
King2349,60,42,0,0,2,17,282,37,19,102,319
King2350,64,65,1,1,4,22,287,62,28,129,349
King2351,76,44,0,1,2,12,254,17,15,120,271
King2352,39,48,0,2,1,10,243,31,13,87,274
King2353,46,94,1,0,0,11,367,53,12,140,420
King2355,58,47,0,2,5,27,226,70,34,105,296
King2357,103,66,1,2,0,21,352,57,24,169,409
King2358,179,118,1,8,15,31,700,70,55,297,770
King2359,61,34,0,2,3,9,264,38,14,95,302
King236,78,93,1,2,2,18,323,54,23,171,377
King2360,63,85,2,3,0,6,411,29,11,148,440
King2361,43,36,1,2,2,22,232,48,27,79,280
King2363,57,57,0,1,1,14,260,35,16,114,295
King2364,57,26,0,0,3,11,248,31,14,83,279
King2366,64,53,0,2,3,13,306,37,18,117,343
King2367,57,65,1,6,9,16,304,63,32,122,367
King2369,89,68,1,3,5,30,283,56,39,157,339
King2370,37,60,1,2,3,18,282,38,24,97,320
King2371,129,77,3,0,3,23,471,69,29,206,540
King2373,108,106,1,2,5,23,594,73,31,214,667
King2375,60,32,0,4,3,4,256,28,11,92,284
King2377,153,54,1,2,8,11,437,52,22,207,489
King2378,69,23,1,0,11,9,227,31,21,92,258
King2379,79,84,2,8,9,16,412,49,35,163,461
King238,78,53,3,13,10,63,342,167,89,131,509
King2381,76,62,6,3,11,94,334,215,114,138,549
King2383,56,43,3,5,5,76,269,193,89,99,462
King2384,39,42,5,17,3,64,173,168,89,81,341
King2386,45,17,0,2,5,23,149,58,30,62,207
King2389,18,30,0,9,1,54,112,160,64,48,272
King239,27,22,5,4,7,75,157,238,91,49,395
King2390,32,50,5,4,5,39,202,145,53,82,347
King2391,33,28,1,5,11,64,127,174,81,61,301
King2394,104,35,3,14,12,29,258,77,58,139,335
King2395,61,22,2,5,4,24,154,50,35,83,204
King2399,50,18,1,2,7,19,129,73,29,68,202
King24,71,52,2,8,2,35,276,77,47,123,353
King240,26,25,6,5,4,58,117,187,73,51,304
King2401,71,28,3,6,22,61,333,163,92,99,496
King2403,48,53,1,4,3,39,228,92,47,101,320
King2404,50,30,1,7,6,49,223,167,63,80,390
King2405,46,45,4,19,12,85,187,258,120,91,445
King2407,72,37,4,10,12,123,287,330,149,109,617
King2409,278,86,10,26,75,183,624,333,294,364,957
King241,90,74,1,10,11,31,389,93,53,164,482
King2410,93,74,4,10,23,58,501,134,95,167,635
King2412,40,17,2,4,13,21,184,52,40,57,236
King2413,62,23,5,6,4,67,167,189,82,85,356
King2416,64,48,2,5,8,49,252,112,64,112,364
King2417,5,1,3,1,0,7,24,24,11,6,48
King2421,56,51,2,13,7,36,242,134,58,107,376
King2423,82,45,1,11,17,59,386,196,88,127,582
King2426,75,40,3,9,6,73,246,137,91,115,383
King2428,94,54,0,5,12,41,379,145,58,148,524
King2429,90,59,2,9,21,54,433,181,86,149,614
King2430,83,35,0,6,26,48,293,126,80,118,419
King2432,37,39,0,2,8,21,221,78,31,76,299
King2434,56,34,0,0,17,32,250,91,49,90,341
King2439,41,38,1,2,4,21,207,37,28,79,244
King2441,62,48,3,9,12,47,271,156,71,110,427
King2443,28,42,1,2,1,16,147,35,20,70,182
King2444,55,49,0,7,6,19,249,82,32,104,331
King2445,78,15,0,1,19,38,282,92,58,93,374
King2446,77,51,5,8,16,89,319,266,118,128,585
King2447,56,40,2,9,17,46,240,132,74,96,372
King2448,54,48,2,4,16,43,297,123,65,102,420
King2449,76,35,0,5,5,44,287,109,54,111,396
King2450,55,37,1,1,14,61,252,165,77,92,417
King2453,61,61,0,3,3,19,311,60,25,122,371
King2455,64,57,1,3,2,35,284,70,41,121,354
King2456,96,63,0,12,20,78,434,191,110,159,625
King2457,88,91,0,13,12,51,378,133,76,179,511
King2459,104,53,5,12,21,86,432,212,124,157,644
King246,47,45,4,12,1,34,194,115,51,92,309
King2460,52,66,5,6,19,85,273,294,115,118,567
King2461,69,64,1,8,9,34,354,131,52,133,485
King2462,41,34,0,4,8,12,162,42,24,75,204
King2465,69,27,0,0,9,34,219,70,43,96,289
King2466,110,80,4,15,13,47,458,136,79,190,594
King2467,75,44,1,1,8,23,244,81,33,119,325
King2469,56,26,1,10,9,44,276,147,64,82,423
King2471,92,61,3,11,19,55,383,185,88,153,568
King2472,83,52,1,7,15,45,328,107,68,135,435
King2473,82,60,1,14,5,44,303,126,64,142,429
King2474,59,45,4,3,18,62,236,144,87,104,380
King2475,79,54,4,7,13,49,371,141,73,133,512
King2477,64,21,4,5,29,114,188,224,152,85,412
King2478,94,42,2,10,12,70,210,152,94,136,362
King248,47,35,1,2,5,24,225,80,32,82,305
King2480,56,42,2,6,7,29,232,96,44,98,328
King2484,38,26,0,3,15,27,217,77,45,64,294
King2485,51,55,3,5,4,47,266,137,59,106,403
King2486,65,52,1,3,13,47,313,135,64,117,448
King2487,62,52,0,8,5,40,303,123,53,114,426
King2488,98,90,2,10,9,72,432,160,93,188,592
King2489,65,62,1,10,6,35,310,110,52,127,420
King2490,70,49,3,6,15,65,312,179,89,119,491
King2491,69,49,2,10,12,50,355,175,74,118,530
King2492,29,41,2,7,7,43,199,83,59,70,282
King2493,69,33,1,11,15,45,281,133,72,102,414
King2495,52,64,2,10,16,44,288,176,72,116,464
King25,89,123,1,12,6,51,405,153,70,212,558
King2500,49,52,0,1,3,7,283,25,11,101,308
King2501,69,16,0,0,9,38,255,61,47,85,316
King2502,98,40,0,4,1,3,309,23,8,138,332
King2503,52,36,0,3,4,14,245,37,21,88,282
King2504,57,40,1,0,4,9,241,14,14,97,255
King2505,74,27,0,4,10,16,238,38,30,101,276
King2506,67,45,1,2,2,8,239,18,13,112,257
King2507,60,45,1,4,4,11,196,31,20,105,227
King2508,87,41,1,2,4,22,322,47,29,128,369
King2509,75,53,0,3,4,17,324,19,24,128,343
King251,54,27,2,3,1,38,213,89,44,81,302
King2510,53,51,1,1,7,11,287,28,20,104,315
King2511,92,42,2,4,10,15,352,51,31,134,403
King2512,102,68,2,2,4,24,385,50,32,170,435
King2513,87,49,0,0,5,18,364,42,23,136,406
King2514,65,20,0,0,6,25,217,51,31,85,268
King2515,62,47,0,0,0,17,316,32,17,109,348
King2517,98,82,3,2,7,32,447,67,44,180,514
King2518,44,59,1,2,2,11,281,35,16,103,316
King252,54,49,3,15,14,44,254,118,76,103,372
King2520,84,66,0,0,1,16,400,43,17,150,443
King2522,70,49,0,3,4,26,264,46,33,119,310
King2523,113,42,1,4,6,26,373,79,37,155,452
King2524,59,24,0,0,1,5,166,15,6,83,181
King2526,95,40,0,2,5,19,333,41,26,135,374
King2527,68,27,1,5,2,12,214,31,20,95,245
King2528,131,42,2,4,12,27,417,74,45,173,491
King2529,79,42,2,3,7,25,319,68,37,121,387
King253,35,66,5,2,5,31,241,90,43,101,331
King2532,70,47,1,2,4,20,300,49,27,117,349
King2533,68,55,0,1,3,11,322,45,15,123,367
King2534,68,79,0,3,7,21,378,50,31,147,428
King2535,85,107,1,0,1,14,426,49,16,192,475
King2536,74,89,0,6,8,17,436,53,31,163,489
King2537,51,68,1,3,2,8,287,39,14,119,326
King2539,133,100,2,10,11,14,584,60,37,233,644
King254,79,80,3,11,18,31,327,114,63,159,441
King2541,23,56,0,0,0,2,255,5,2,79,260
King2542,49,38,0,1,2,2,216,12,5,87,228
King2543,33,54,0,0,0,0,294,4,0,87,298
King2544,32,25,0,0,5,8,223,30,13,57,253
King2545,94,98,0,1,0,11,580,17,12,192,597
King2546,46,68,0,0,0,2,309,5,2,114,314
King2547,37,62,0,1,0,1,343,15,2,99,358
King2549,102,88,1,0,0,20,543,29,21,190,572
King255,80,73,9,19,11,80,450,229,119,153,679
King2550,49,69,0,0,0,1,329,9,1,118,338
King2551,75,45,1,11,1,55,392,183,68,120,575
King2552,80,51,0,4,7,36,282,64,47,131,346
King2554,80,42,2,6,18,32,352,128,58,122,480
King2556,79,29,1,6,28,71,308,198,106,108,506
King2559,64,24,1,3,5,50,233,104,59,88,337
King256,86,53,4,10,8,57,361,183,79,139,544
King2560,74,60,0,10,5,29,371,134,44,134,505
King2561,66,56,3,12,8,42,331,153,65,122,484
King2563,51,65,2,10,12,49,284,137,73,116,421
King2564,76,75,0,2,12,45,424,130,59,151,554
King2565,50,45,1,6,9,41,258,96,57,95,354
King2566,47,28,0,7,5,22,179,72,34,75,251
King2567,43,41,1,7,4,35,165,106,47,84,271
King2568,91,75,5,18,3,88,353,237,114,166,590
King2569,96,81,0,13,8,57,421,213,78,177,634
King257,78,79,4,12,22,49,378,167,87,157,545
King2570,59,52,0,10,8,49,247,129,67,111,376
King2573,89,62,2,15,9,81,313,212,107,151,525
King2575,80,47,3,11,30,56,387,182,100,127,569
King2576,27,34,3,2,12,90,125,235,107,61,360
King258,119,89,2,18,18,50,493,179,88,208,672
King2580,56,41,0,10,10,28,209,88,48,97,297
King2581,77,58,3,13,7,39,370,104,62,135,474
King2582,116,75,1,4,2,22,581,100,29,191,681
King2583,78,54,1,7,7,63,496,206,78,132,702
King2584,69,86,4,5,9,77,313,241,95,155,554
King2585,94,55,8,20,18,82,407,252,128,149,659
King2586,41,44,2,14,2,49,217,172,67,85,389
King2589,37,62,1,11,7,61,272,191,80,99,463
King259,36,66,4,3,4,32,263,96,43,102,359
King2590,41,74,0,2,3,8,291,30,13,115,321
King2592,56,50,0,4,3,2,298,16,9,106,314
King2593,57,39,0,1,6,3,232,16,10,96,248
King2594,62,43,4,5,9,41,275,139,59,105,414
King2595,66,59,1,4,5,33,286,71,43,125,357
King2597,73,70,2,8,7,45,371,140,62,143,511
King2598,101,26,6,7,15,39,336,109,67,127,445
King2599,98,48,4,6,10,71,346,202,91,146,548
King26,27,33,4,10,4,36,131,99,54,60,230
King260,139,59,5,21,33,83,392,204,142,198,596
King2600,62,47,3,5,17,53,348,174,78,109,522
King2601,70,41,1,5,9,58,297,129,73,111,426
King2602,65,68,3,8,17,43,463,191,71,133,654
King2603,76,62,2,9,15,83,323,240,109,138,563
King2605,53,35,2,6,14,23,228,100,45,88,328
King2606,77,54,8,12,13,92,341,248,125,131,589
King2607,58,41,2,4,9,15,347,79,30,99,426
King261,71,86,5,14,10,58,435,170,87,157,605
King2614,55,85,4,14,6,82,320,263,106,140,583
King2615,52,50,5,22,10,126,184,347,163,102,531
King2616,29,21,1,1,6,17,102,60,25,50,162
King2618,62,74,2,9,8,63,359,182,82,136,541
King2619,67,76,2,8,3,17,363,53,30,143,416
King262,78,50,4,9,11,38,431,189,62,128,620
King2620,64,38,1,3,9,40,294,105,53,102,399
King2621,67,53,2,4,1,37,305,84,44,120,389
King2623,73,31,0,7,9,37,207,104,53,104,311
King2625,53,47,1,7,5,42,229,116,55,100,345
King2626,75,21,0,12,17,65,179,125,94,96,304
King2627,58,31,2,10,11,48,162,116,71,89,278
King2628,32,66,1,5,9,13,333,57,28,98,390
King2629,68,68,1,1,6,32,342,110,40,136,452
King2630,67,26,1,2,20,45,244,67,68,93,311
King2632,21,15,0,4,6,11,121,40,21,36,161
King2633,87,57,2,4,10,49,356,128,65,144,484
King2634,62,26,1,2,11,35,190,83,49,88,273
King2635,53,23,0,2,6,21,216,65,29,76,281
King2636,64,28,1,6,5,21,286,73,33,92,359
King2637,54,48,2,8,5,49,253,106,64,102,359
King2638,49,59,0,4,5,26,238,92,35,108,330
King2640,55,56,6,0,3,25,260,66,34,111,326
King2641,100,58,2,6,16,32,400,123,56,158,523
King2643,42,45,2,6,3,27,244,71,38,87,315
King2644,36,41,2,2,8,37,172,73,49,77,245
King2645,69,24,1,6,5,30,198,68,42,93,266
King2646,91,63,2,16,10,50,301,135,78,154,436
King2650,70,52,0,10,12,45,288,145,67,122,433
King2651,57,31,1,7,9,39,224,112,56,88,336
King2652,77,91,4,14,10,56,415,215,84,168,630
King2653,35,24,1,5,4,42,172,120,52,59,292
King2654,77,46,1,7,13,66,292,163,87,123,455
King2655,54,43,1,11,4,48,279,124,64,97,403
King2656,59,39,3,7,10,48,299,95,68,98,394
King2657,39,34,2,2,2,22,192,81,28,73,273
King2658,79,93,4,22,6,105,351,295,137,172,646
King2659,37,8,4,1,7,15,84,44,27,45,128
King2666,57,34,8,15,12,45,270,132,80,91,402
King2667,54,46,0,4,4,27,272,94,35,100,366
King267,80,70,1,5,4,30,388,98,40,150,486
King2671,132,51,5,15,18,83,383,212,121,183,595
King2672,56,39,3,4,12,31,253,107,50,95,360
King2673,29,39,1,2,0,17,158,84,20,68,242
King2674,62,51,2,5,2,42,262,125,51,113,387
King2676,89,85,7,10,7,60,439,194,84,174,633
King2677,44,27,0,6,6,24,197,86,36,71,283
King2678,77,68,2,10,9,50,376,148,71,145,524
King2679,76,45,1,11,4,63,320,149,79,121,469
King2680,88,51,1,10,15,45,355,125,71,139,480
King2683,70,51,7,4,11,60,350,190,82,121,540
King2684,35,16,0,2,8,43,169,85,53,51,254
King2686,103,92,0,1,4,23,432,73,28,195,505
King2689,63,43,0,10,8,61,247,135,79,106,382
King2690,78,40,0,5,10,40,310,132,55,118,442
King2691,39,76,2,3,3,33,333,75,41,115,408
King2692,48,22,0,2,12,32,190,110,46,70,300
King2693,82,74,4,6,6,36,398,169,52,156,567
King2699,37,17,0,4,1,42,162,105,47,54,267
King270,31,22,0,1,1,7,149,40,9,53,189
King2700,27,22,1,1,0,17,90,38,19,49,128
King2701,30,33,2,3,3,42,159,139,50,63,298
King2702,26,35,2,1,1,41,165,90,45,61,255
King2703,15,18,3,4,0,17,91,56,24,33,147
King2704,100,58,2,8,14,63,362,222,87,158,584
King2705,59,28,3,12,3,35,213,108,53,87,321
King2707,47,21,2,12,6,41,194,135,61,68,329
King2708,53,36,5,9,3,34,202,134,51,89,336
King2709,88,68,0,9,13,69,434,212,91,156,646
King271,93,62,1,3,0,29,394,85,33,155,479
King2710,58,53,1,7,10,39,297,155,57,111,452
King2711,46,54,6,3,7,48,215,167,64,100,382
King2714,97,32,0,2,15,62,365,143,79,129,508
King2715,66,26,2,3,12,26,282,101,43,92,383
King2716,59,74,0,5,2,32,323,77,39,133,400
King2718,67,50,2,4,19,32,375,116,57,117,491
King2719,64,26,2,5,15,35,265,124,57,90,389
King272,51,41,3,11,4,57,220,114,75,92,334
King2720,67,40,1,12,9,86,231,228,108,107,459
King2721,33,22,1,2,4,54,144,148,61,55,292
King2722,55,50,4,10,11,37,320,126,62,105,446
King2723,97,35,4,4,5,92,227,163,105,132,390
King2725,77,68,3,20,9,60,428,204,92,145,632
King2726,31,46,1,5,10,36,235,133,52,77,368
King2728,46,26,2,3,6,37,193,96,48,72,289
King2729,30,46,6,3,4,31,151,133,44,76,284
King273,62,22,1,3,7,37,198,85,48,84,283
King2730,79,80,4,7,6,45,368,119,62,159,487
King2731,50,35,0,4,6,29,255,86,39,85,341
King2733,100,69,3,10,22,66,466,177,101,169,643
King2734,58,58,0,9,11,43,301,150,63,116,451
King2736,38,53,5,10,9,56,230,169,80,91,399
King2737,46,37,7,9,11,46,295,145,73,83,440
King2739,44,34,1,4,4,11,188,31,20,78,219
King274,50,32,1,0,5,18,196,43,24,82,239
King2740,34,26,1,6,6,37,174,129,50,60,303
King2741,61,44,3,15,8,72,251,218,98,105,469
King2742,51,58,3,4,4,67,298,210,78,109,508
King2743,96,101,2,3,10,36,422,105,51,197,527
King2746,34,50,3,7,12,41,192,153,63,84,345
King2748,54,69,3,12,7,66,307,250,88,123,557
King2749,47,47,0,1,1,9,294,34,11,94,328
King2750,77,49,0,2,3,17,316,63,22,126,379
King2751,33,21,0,3,2,33,129,64,38,54,193
King2752,67,47,2,4,8,34,264,93,48,114,357
King2753,62,71,3,6,3,13,286,55,25,133,341
King2754,47,24,0,2,9,39,195,82,50,71,277
King2759,81,66,3,2,4,61,373,161,70,147,534
King2760,85,72,5,15,5,48,337,143,73,157,480
King2761,79,76,2,9,8,47,353,127,66,155,480
King2762,85,55,4,9,11,39,314,123,63,140,437
King2763,56,29,1,3,4,18,177,42,26,85,219
King2764,30,23,0,2,6,16,170,41,24,53,211
King2765,117,64,1,11,10,56,417,135,78,181,552
King2767,81,55,1,9,24,56,359,122,90,136,481
King2768,86,81,2,13,5,37,348,132,57,167,480
King2769,79,61,4,18,22,61,396,186,105,140,582
King277,32,28,2,2,4,14,164,37,22,60,201
King2771,67,67,3,18,11,50,384,176,82,134,560
King2772,46,22,0,2,9,29,194,69,40,68,263
King2773,50,29,0,0,7,20,169,57,27,79,226
King2774,63,38,2,4,12,19,192,66,37,101,258
King2775,62,46,6,4,11,28,306,102,49,108,408
King2776,66,60,3,16,10,41,245,108,70,126,353
King2777,26,22,2,2,2,13,119,50,19,48,169
King2778,34,15,2,4,11,12,153,45,29,49,198
King278,66,43,0,1,4,8,191,35,13,109,226
King2782,22,28,0,5,2,19,111,39,26,50,150
King2783,72,64,3,11,2,57,303,134,73,136,437
King2785,47,46,2,7,9,48,252,114,66,93,366
King2786,80,32,0,3,3,15,233,52,21,112,285
King2788,44,12,1,5,10,48,201,91,64,56,292
King2789,21,58,0,9,3,16,255,52,28,79,307
King279,74,47,4,9,9,93,330,296,115,121,626
King2790,66,31,0,8,11,44,319,110,63,97,429
King2791,82,44,2,12,14,39,379,127,67,126,506
King2795,69,92,1,4,4,8,594,52,17,161,646
King2796,68,53,0,8,1,10,280,37,19,121,317
King2799,54,70,0,0,0,4,347,16,4,124,363
King28,53,44,1,10,8,34,241,132,53,97,373
King280,35,53,3,6,5,64,148,186,78,88,334
King2802,30,32,0,9,3,29,133,96,41,62,229
King2803,54,49,1,3,14,31,273,112,49,103,385
King2804,70,55,2,8,8,64,256,177,82,125,433
King2806,52,42,0,3,12,22,243,83,37,94,326
King2808,53,13,0,0,12,17,178,43,29,66,221
King2809,46,15,2,0,5,20,164,39,27,61,203
King2810,37,27,3,8,12,45,211,174,68,64,385
King2811,44,30,0,9,4,29,191,107,42,74,298
King2812,43,35,0,2,4,31,177,67,37,78,244
King2813,71,26,2,14,10,55,294,151,81,97,445
King2815,78,65,1,5,2,27,344,100,35,143,444
King2816,71,36,2,7,13,57,292,139,79,107,431
King282,38,43,3,2,0,33,206,114,38,81,320
King2820,33,32,1,2,2,32,184,97,37,65,281
King283,90,64,4,8,2,24,408,78,38,154,486
King2831,65,45,0,7,6,63,313,182,76,110,495
King2832,65,58,4,18,10,143,229,381,175,123,610
King2834,58,50,2,8,5,45,244,147,60,108,391
King2836,45,41,3,14,8,36,257,130,61,86,387
King2837,33,35,3,27,19,106,207,361,155,68,568
King2838,58,62,1,9,9,59,281,160,78,120,441
King2839,73,61,5,9,14,100,272,230,128,134,502
King2840,48,46,0,15,12,71,174,195,98,94,369
King2841,22,23,1,6,6,44,128,127,57,45,255
King2843,64,70,11,19,8,49,319,247,87,134,566
King2844,120,53,0,8,4,36,479,141,48,173,620
King2845,53,50,2,7,1,22,277,77,32,103,354
King2848,32,19,1,1,3,39,158,94,44,51,252
King2850,53,46,1,1,0,11,307,23,13,99,330
King2852,48,78,0,0,3,4,426,22,7,126,448
King2853,49,43,0,1,1,1,388,14,3,92,402
King2854,75,51,5,6,7,24,376,144,42,126,520
King2856,53,55,2,8,1,50,236,177,61,108,413
King2857,67,41,5,10,20,83,262,256,118,108,518
King2859,55,44,4,19,10,80,192,217,113,99,409
King2861,86,42,0,0,4,11,316,25,15,128,341
King2862,74,56,0,1,6,13,416,63,20,130,479
King2863,38,30,0,4,17,32,233,99,53,68,332
King2864,57,41,0,7,2,50,233,135,59,98,368
King2865,39,27,1,2,9,39,214,91,51,66,305
King289,50,57,1,3,4,24,230,79,32,107,309
King290,55,55,5,7,7,49,264,130,68,110,394
King2904,51,33,7,12,14,104,188,276,137,84,464
King2905,25,11,1,1,0,10,153,25,12,36,178
King2906,70,36,3,0,16,48,264,114,67,106,378
King2907,62,38,0,4,16,48,314,124,68,100,438
King2908,52,35,2,3,11,32,226,95,48,87,321
King2909,72,33,4,8,21,55,326,140,88,105,466
King2910,46,56,3,5,4,28,226,88,40,102,314
King2911,33,42,2,0,3,13,181,57,18,75,238
King2912,24,47,0,0,4,19,230,74,23,71,304
King2913,84,54,4,4,12,38,362,155,58,138,517
King2914,92,58,0,14,14,50,406,181,78,150,587
King2915,51,32,2,2,2,35,205,84,41,83,289
King2916,34,30,1,3,2,17,170,56,23,64,226
King2917,46,72,2,2,2,33,340,127,39,118,467
King2918,72,53,0,7,7,51,365,132,65,125,497
King2919,47,33,1,3,2,27,247,76,33,80,323
King292,57,101,1,3,5,12,327,38,21,158,365
King2920,53,38,2,3,6,37,213,95,48,91,308
King2921,56,23,1,11,8,23,209,80,43,79,289
King2922,43,34,3,3,9,30,260,128,45,77,388
King2923,91,75,1,3,9,29,363,100,42,166,463
King2924,87,53,1,7,11,44,487,142,63,140,629
King2925,54,36,0,1,18,40,291,102,59,90,393
King2926,17,11,0,2,9,42,129,107,53,28,236
King2928,89,99,1,1,0,13,529,21,15,188,550
King2929,92,55,0,12,16,39,343,113,67,147,456
King293,90,40,0,10,14,53,323,132,77,130,455
King2931,56,47,0,3,5,20,233,67,28,103,300
King2932,54,53,1,6,2,40,239,93,49,107,332
King2933,50,24,0,1,6,22,179,80,29,74,259
King2934,44,17,2,6,16,29,204,72,53,61,276
King2935,63,34,3,6,5,25,277,81,39,97,358
King2936,71,28,2,2,12,39,273,94,55,99,367
King2937,47,27,0,2,9,42,241,112,53,74,353
King2938,77,18,1,3,2,66,174,114,72,95,288
King2939,23,13,2,3,0,26,136,84,31,36,220
King2940,34,23,3,2,4,15,149,47,24,57,196
King2941,58,44,3,5,17,31,259,119,56,102,378
King2942,86,37,1,1,22,66,371,199,90,123,570
King2943,101,31,3,3,23,63,448,175,92,132,623
King2945,56,30,2,6,11,28,321,89,47,86,410
King2949,68,65,1,2,1,46,312,99,50,133,411
King295,71,69,1,6,3,34,304,97,44,140,401
King2951,80,54,2,5,9,34,322,96,50,134,418
King2952,38,25,0,4,2,23,180,36,29,63,216
King2955,80,53,1,5,2,43,370,115,51,133,485
King2956,46,34,0,4,2,16,267,53,22,80,320
King2959,29,44,3,7,6,38,237,146,54,73,383
King296,46,60,0,3,1,11,256,44,15,106,300
King2961,58,49,1,2,13,42,294,108,58,107,402
King2962,36,47,2,3,3,24,276,84,32,83,360
King2963,118,42,3,6,14,63,454,201,86,160,655
King2964,33,45,1,8,10,42,164,109,61,78,273
King2965,73,34,3,10,12,33,364,113,58,107,477
King2966,39,52,0,1,6,21,300,68,28,91,368
King2967,65,122,1,5,12,35,608,135,53,187,743
King2968,65,67,2,8,8,26,494,88,44,132,582
King2969,58,29,4,3,10,48,241,96,65,87,337
King297,28,25,0,2,2,23,97,64,27,53,161
King2970,86,77,3,11,16,74,365,153,104,163,518
King2971,43,16,0,3,11,18,177,81,32,59,258
King2972,99,74,3,10,17,38,472,176,68,173,648
King2973,80,43,2,2,26,69,403,194,99,123,597
King2974,76,46,4,11,8,60,347,184,83,122,531
King2975,44,25,1,2,5,36,218,110,44,69,328
King2977,34,24,2,4,4,19,216,72,29,58,288
King298,87,70,3,6,4,44,373,117,57,157,490
King2982,31,48,5,13,5,43,224,157,66,79,381
King2984,47,43,3,7,11,37,189,124,58,90,313
King2985,61,44,5,17,7,32,289,97,61,105,386
King2986,77,41,2,9,11,60,284,211,82,118,495
King2987,11,29,0,3,1,4,200,32,8,40,232
King2988,104,67,6,6,10,81,283,158,103,171,441
King2990,73,43,2,8,5,41,277,143,56,116,420
King2991,48,18,3,6,3,33,149,79,45,66,228
King2992,48,38,4,3,1,26,180,66,34,86,246
King2993,74,62,1,4,11,53,300,166,69,136,466
King2994,16,14,4,3,1,13,84,74,21,30,158
King2995,29,22,0,1,0,17,108,65,18,51,173
King2996,92,35,8,12,6,57,290,142,83,127,432
King2999,32,36,0,3,4,23,177,87,30,68,264
King3,79,55,1,4,11,29,306,86,45,134,392
King300,15,14,1,3,1,27,81,63,32,29,144
King3000,39,52,3,8,4,38,209,113,53,91,322
King3001,107,56,7,16,12,77,319,180,112,163,499
King3002,84,81,2,9,2,49,350,137,62,165,487
King3003,51,43,3,12,10,62,269,176,87,94,445
King3004,38,47,0,0,3,41,193,95,44,85,288
King3005,42,26,2,3,3,45,153,76,53,68,229
King3006,42,53,1,6,1,38,231,116,46,95,347
King3007,20,25,1,5,7,34,86,88,47,45,174
King3008,33,37,1,5,1,28,146,75,35,70,221
King301,44,39,1,14,6,57,169,167,78,83,336
King3010,44,24,3,5,7,32,130,117,47,68,247
King3011,34,32,0,0,5,24,167,86,29,66,253
King3012,45,27,1,2,9,33,179,68,45,72,247
King3013,19,22,0,3,3,32,110,78,38,41,188
King3014,54,32,2,6,20,57,201,141,85,86,342
King3015,39,32,1,6,4,60,165,148,71,71,313
King3017,105,47,3,12,21,101,330,204,137,152,534
King3018,51,28,2,5,2,17,163,66,26,79,229
King3019,51,27,3,11,12,55,165,154,81,78,319
King3020,61,39,1,9,5,35,229,105,50,100,334
King3021,72,45,0,6,7,47,274,141,60,117,415
King3022,24,12,1,1,4,25,93,76,31,36,169
King3023,52,47,2,10,7,55,187,119,74,99,306
King3024,58,25,0,5,9,48,153,111,62,83,264
King3025,60,57,6,17,16,68,215,204,107,117,419
King3026,47,36,1,3,4,40,175,96,48,83,271
King3027,73,45,5,10,4,43,276,147,62,118,423
King3028,46,50,1,11,12,47,199,142,71,96,341
King3029,29,30,1,4,2,16,145,33,23,59,178
King3030,41,25,3,8,2,33,166,111,46,66,277
King3031,64,46,1,8,4,43,253,135,56,110,388
King3032,25,20,0,1,2,14,116,59,17,45,175
King3033,44,36,1,3,0,42,180,108,46,80,288
King3034,36,29,0,5,3,29,131,84,37,65,215
King3035,27,21,2,7,1,20,119,68,30,48,187
King3036,40,31,3,1,0,19,162,88,23,71,250
King3037,44,40,1,3,6,23,161,91,33,84,252
King3038,31,15,0,4,2,21,104,44,27,46,148
King3039,51,28,0,2,5,24,186,76,31,79,262
King3040,19,35,2,9,2,26,197,97,39,54,294
King3041,38,26,0,5,2,15,164,43,22,64,207
King3042,31,22,2,0,4,36,114,69,42,53,183
King3043,52,39,4,3,2,68,237,191,77,91,428
King3044,75,47,5,5,9,79,294,205,98,122,499
King3045,81,50,2,4,3,53,310,144,62,131,454
King3046,51,36,1,7,3,39,188,108,50,87,296
King3047,60,45,0,6,4,47,204,123,57,105,327
King3048,57,47,1,4,0,29,306,91,34,104,397
King3049,50,40,4,2,3,33,182,82,42,90,264
King305,56,43,1,5,12,38,258,103,56,99,361
King3050,24,14,5,2,1,12,103,45,20,38,148
King3051,28,38,0,7,2,24,192,72,33,66,264
King3052,47,17,2,3,2,59,203,135,66,64,338
King3053,47,33,0,6,4,47,206,136,57,80,342
King3054,50,24,3,2,0,22,189,83,27,74,272
King3055,112,47,11,9,5,52,291,142,77,159,433
King3056,38,26,0,6,2,24,158,85,32,64,243
King3057,58,80,0,7,4,60,271,147,71,138,418
King3059,68,54,1,5,2,37,342,99,45,122,441
King3060,46,27,0,3,4,27,177,64,34,73,241
King3061,44,22,0,4,3,30,168,77,37,66,245
King3062,35,24,3,5,5,34,149,79,47,59,228
King3063,45,37,0,3,4,29,168,77,36,82,245
King3064,26,31,2,5,0,32,198,92,39,57,290
King3065,45,29,4,3,1,22,238,57,30,74,295
King3066,47,48,1,3,2,40,205,85,46,95,290
King3068,53,37,6,6,6,55,198,150,73,90,348
King3069,49,40,0,2,2,32,184,72,36,89,256
King307,70,24,2,7,11,58,258,191,78,94,449
King3070,43,32,0,3,2,26,173,81,31,75,254
King3073,54,24,0,3,1,28,166,75,32,78,241
King3074,52,40,2,7,11,50,213,111,70,92,324
King3075,28,22,3,5,2,21,124,56,31,50,180
King3076,75,52,4,13,5,59,281,125,81,127,406
King3077,51,22,1,8,2,43,166,102,54,73,268
King3078,43,32,5,6,1,46,158,105,58,75,263
King3079,56,34,2,6,15,68,242,147,91,90,389
King3080,47,55,0,2,0,31,269,88,33,102,357
King3081,84,62,2,2,7,39,414,113,50,146,527
King3083,42,67,1,7,8,55,223,163,71,109,386
King3085,44,42,2,5,4,35,205,119,46,86,324
King3086,58,35,1,8,9,43,248,150,61,93,398
King3087,58,39,4,9,4,65,239,115,82,97,354
King3088,73,47,5,3,10,49,275,120,67,120,395
King309,101,77,4,7,9,41,372,89,61,178,461
King3090,48,30,7,4,6,37,186,95,54,78,281
King3091,72,37,5,9,17,82,264,201,113,109,465
King3092,89,73,5,4,1,36,382,101,46,162,483
King3093,67,45,1,2,3,46,272,127,52,112,399
King3094,66,48,2,12,11,51,240,198,76,114,438
King3095,32,41,0,9,1,35,214,122,45,73,336
King3096,61,43,3,9,11,34,262,122,57,104,384
King3097,96,53,3,2,8,66,377,186,79,149,563
King3098,69,31,0,3,10,42,237,127,55,100,364
King31,80,52,3,4,5,61,330,149,73,132,479
King310,77,80,1,1,6,18,287,44,26,157,331
King3100,83,65,0,9,1,42,399,127,52,148,526
King3101,94,34,2,4,1,62,185,113,69,128,298
King3102,77,72,1,5,2,37,321,133,45,149,454
King3104,65,51,1,5,2,32,267,105,40,116,372
King3107,85,74,2,2,2,41,318,149,47,159,467
King3109,51,46,0,1,9,35,265,87,45,97,352
King311,100,65,2,5,5,31,303,79,43,165,382
King3110,31,36,1,15,7,34,155,77,57,67,232
King3127,41,38,0,4,1,18,177,43,23,79,220
King3128,81,97,5,8,4,32,403,114,49,178,517
King313,27,43,2,3,8,59,141,153,72,70,294
King3131,35,24,4,6,3,19,121,66,32,59,187
King3132,47,38,4,16,8,98,195,272,126,85,467
King3134,30,20,1,2,6,17,203,43,26,50,246
King3136,20,23,2,2,3,31,94,90,38,43,184
King3138,61,35,1,2,9,31,247,94,43,96,341
King314,38,70,2,10,4,70,208,188,86,108,396
King3140,47,17,0,1,9,33,159,55,43,64,214
King3141,42,30,2,9,1,67,159,164,79,72,323
King3143,59,20,0,4,7,26,198,77,37,79,275
King3144,82,42,3,4,8,41,290,100,56,124,390
King3145,94,56,1,11,20,65,463,189,97,150,652
King3146,83,57,3,16,9,91,302,269,119,140,571
King3147,46,52,1,6,4,15,287,79,26,98,366
King3148,54,81,0,6,7,41,344,134,54,135,478
King315,55,44,1,18,4,101,172,297,124,99,469
King3150,58,74,1,9,11,91,301,231,112,132,532
King3151,54,66,2,9,9,64,346,175,84,120,521
King3153,52,48,1,3,1,7,298,28,12,100,326
King3154,111,79,1,8,2,39,449,120,50,190,569
King3159,134,69,0,1,0,37,543,75,38,203,618
King3162,19,16,0,1,2,19,94,64,22,35,158
King3164,41,38,0,4,4,26,223,107,34,79,330
King3166,93,40,3,8,30,54,409,132,95,133,541
King3172,39,51,0,5,0,18,291,65,23,90,356
King3174,101,52,0,4,7,57,357,161,68,153,518
King3175,68,53,0,3,1,8,307,32,12,121,339
King318,47,17,0,8,5,34,185,72,47,64,257
King3180,56,54,1,4,3,21,256,88,29,110,344
King3181,57,31,0,12,16,112,255,251,140,88,506
King3184,76,52,3,7,10,83,352,229,103,128,581
King3186,33,26,2,9,2,77,148,217,90,59,365
King3187,51,34,1,5,0,47,203,150,53,85,353
King3189,77,54,1,2,4,36,367,110,43,131,477
King319,39,46,3,4,4,15,172,41,26,85,213
King3190,63,48,0,7,9,31,353,133,47,111,486
King3192,49,18,2,8,6,30,171,88,46,67,259
King3193,56,46,3,12,20,34,281,126,69,102,407
King3195,61,43,2,6,6,51,275,133,65,104,408
King3196,45,40,0,5,9,28,260,85,42,85,345
King3198,50,51,0,12,1,19,287,76,32,101,363
King3199,46,44,1,8,9,14,227,81,32,90,308
King320,35,34,0,8,4,66,202,192,78,69,394
King3200,43,38,3,3,5,39,245,103,50,81,348
King3201,53,59,5,5,3,58,284,174,71,112,458
King3202,47,24,0,1,8,13,183,47,22,71,230
King3203,84,51,0,5,15,51,333,118,71,135,451
King3204,108,77,3,11,10,51,460,131,75,185,591
King3205,41,31,2,6,6,40,156,90,54,72,246
King3206,76,93,3,5,11,53,464,140,72,169,604
King3208,42,31,2,4,8,25,243,87,39,73,330
King321,38,5,0,4,17,44,148,103,65,43,251
King3210,54,57,1,8,9,56,353,170,74,111,523
King3211,73,63,2,14,23,61,392,205,100,136,597
King3212,76,26,1,8,12,78,256,174,99,102,430
King3213,61,50,6,6,7,34,292,108,53,111,400
King3214,43,29,4,3,6,34,199,131,47,72,330
King3215,80,55,2,10,14,45,487,145,71,135,632
King3216,84,53,0,6,9,50,411,148,65,137,559
King3217,65,40,1,11,12,49,372,131,73,105,503
King3218,81,69,2,11,6,75,428,242,94,150,670
King3219,41,54,1,10,7,44,245,155,62,95,400
King322,19,10,1,0,10,30,116,69,41,29,185
King3220,38,19,0,4,11,40,224,104,55,57,328
King3221,54,49,3,8,3,62,300,176,76,103,476
King3222,58,54,4,11,9,50,221,173,74,112,394
King3223,24,34,0,2,1,21,124,60,24,58,184
King3224,41,23,4,3,2,26,236,84,35,64,320
King3225,60,26,1,6,8,16,315,73,31,86,388
King3226,77,25,0,5,20,28,305,86,53,102,391
King3227,66,43,2,13,13,37,232,107,65,109,339
King3228,58,44,0,9,7,44,243,107,60,102,350
King323,48,16,2,2,28,54,196,107,86,64,303
King3230,113,56,0,5,10,26,456,74,41,169,530
King3232,64,46,3,6,6,24,263,81,39,110,344
King3233,73,41,0,2,4,29,238,81,35,114,319
King3234,30,19,2,9,3,20,174,85,34,49,259
King3235,47,35,4,3,1,30,178,109,38,82,287
King3236,101,61,2,6,9,63,408,209,80,162,617
King3237,76,58,3,15,16,74,341,207,108,134,548
King3238,30,26,2,2,1,30,159,84,35,56,243
King324,50,25,1,4,18,35,199,106,58,75,305
King3241,107,51,1,3,14,50,419,134,68,158,553
King3242,46,42,6,12,4,44,218,170,66,88,388
King3244,25,34,1,5,0,41,155,124,47,59,279
King3245,54,46,3,12,18,81,242,228,114,100,470
King3246,22,21,3,1,4,34,102,101,42,43,203
King3247,70,53,2,12,10,97,248,288,121,123,536
King3248,52,47,8,14,16,116,224,323,154,99,547
King325,61,16,1,1,22,51,229,110,75,77,339
King3252,46,68,0,2,5,21,312,41,28,114,353
King326,36,11,2,3,9,24,117,87,38,47,204
King3260,55,35,5,15,15,60,223,238,95,90,461
King3261,61,43,5,8,12,37,241,150,62,104,391
King3262,55,33,0,1,3,4,263,13,8,88,276
King3263,45,42,0,4,2,17,259,67,23,87,326
King3264,41,53,0,2,1,13,223,35,16,94,258
King3265,48,58,0,3,3,10,246,26,16,106,272
King3266,36,46,1,1,1,6,226,25,9,82,251
King3267,51,57,0,1,5,18,367,40,24,108,407
King3268,48,50,7,16,15,134,227,335,172,98,562
King3269,33,37,3,0,8,65,153,177,76,70,330
King327,72,63,1,9,15,66,355,199,91,135,554
King3270,54,32,1,10,10,37,288,139,58,86,427
King3271,69,45,0,3,6,30,261,89,39,114,350
King3272,34,62,0,13,5,63,191,195,81,96,386
King3273,46,36,3,12,7,46,215,162,68,82,377
King3275,96,41,1,10,4,52,360,195,67,137,555
King3276,46,43,4,8,9,55,202,177,76,89,379
King3278,46,16,1,2,3,20,152,58,26,62,210
King3279,84,50,3,6,6,59,328,199,74,134,527
King328,63,51,10,13,20,76,248,225,119,114,473
King3280,44,46,0,8,7,71,238,195,86,90,433
King3281,63,77,3,4,4,19,390,84,30,140,474
King3282,95,52,4,3,17,69,434,137,93,147,571
King3283,83,80,1,6,8,40,453,124,55,163,577
King3284,106,55,0,8,20,97,419,188,125,161,607
King3287,86,36,4,2,9,43,370,167,58,122,537
King3289,74,51,5,17,6,77,407,200,105,125,607
King3290,48,59,4,15,11,32,221,143,62,107,364
King3291,38,14,0,5,3,7,184,38,15,52,222
King3292,65,41,1,5,16,23,246,68,45,106,314
King3293,71,56,1,8,8,44,377,166,61,127,543
King3294,45,36,2,11,11,59,198,185,83,81,383
King3295,60,43,6,16,12,97,260,300,131,103,560
King3296,69,63,3,9,15,79,334,204,106,132,538
King3298,63,42,1,8,5,46,300,137,60,105,437
King3299,61,51,2,13,17,107,302,310,139,112,612
King33,81,75,2,5,2,60,346,154,69,156,500
King330,46,52,1,3,8,15,183,32,27,98,215
King3300,50,29,3,11,8,41,228,131,63,79,359
King3302,59,59,1,5,9,91,250,268,106,118,518
King3303,19,18,5,8,6,34,79,94,53,37,173
King3304,44,32,8,16,2,84,153,215,110,76,368
King3305,34,27,4,2,6,14,199,59,26,61,258
King3306,55,33,1,5,6,31,303,92,43,88,395
King3307,49,27,2,3,3,17,172,41,25,76,213
King3308,38,22,1,3,8,17,151,85,29,60,236
King331,101,67,5,6,10,66,353,130,87,168,483
King3310,36,40,2,9,5,71,158,196,87,76,354
King3312,102,42,0,9,20,66,444,172,95,144,616
King3313,84,64,5,9,4,29,404,116,47,148,520
King3315,165,40,8,12,70,90,419,192,180,205,611
King3316,58,99,0,8,4,40,508,137,52,157,645
King3317,104,108,0,5,5,16,654,41,26,212,695
King3318,104,110,1,3,6,16,655,44,26,214,699
King3319,81,94,0,1,6,15,709,70,22,175,779
King3320,62,45,0,3,4,18,310,61,25,107,371
King3321,65,33,0,3,8,53,231,124,64,98,355
King3322,29,40,0,6,8,44,155,121,58,69,276
King3323,42,38,2,11,4,33,232,113,50,80,345
King3324,76,31,7,11,31,74,229,171,123,107,400
King3326,42,30,2,5,11,40,256,97,58,72,353
King3327,56,28,1,4,7,44,187,120,56,84,307
King3328,82,62,0,17,20,61,384,217,98,144,601
King3329,37,38,2,3,6,37,147,98,48,75,245
King333,23,14,2,2,4,10,112,32,18,37,144
King3330,37,18,0,1,9,20,159,61,30,55,220
King3331,52,45,1,4,5,27,226,75,37,97,301
King3332,110,73,4,5,13,90,406,246,112,183,652
King3333,44,41,1,3,9,55,198,152,68,85,350
King3334,50,66,0,14,4,33,246,123,51,116,369
King3335,73,64,5,8,6,77,317,215,96,137,532
King3337,140,41,4,12,29,91,536,248,136,181,784
King3338,45,38,0,6,2,43,190,119,51,83,309
King3339,93,91,0,1,0,22,379,49,23,184,428
King3340,62,75,0,1,5,27,296,54,33,137,350
King3341,105,72,0,3,5,18,459,60,26,177,519
King3344,60,37,3,6,14,57,215,156,80,97,371
King3345,85,59,0,0,5,16,385,47,21,144,432
King335,46,47,4,1,4,38,238,62,47,93,300
King3359,54,45,0,9,6,27,257,102,42,99,359
King336,113,64,1,6,4,14,376,55,25,177,431
King3362,41,35,4,5,0,32,155,83,41,76,238
King3363,31,53,0,3,5,14,244,49,22,84,293
King3365,22,21,0,3,3,49,108,112,55,43,220
King3366,28,34,1,8,2,30,131,119,41,62,250
King3367,61,46,3,8,15,75,267,257,101,107,524
King3368,45,67,8,11,10,67,312,257,96,112,569
King3369,92,49,5,19,22,93,273,260,139,141,533
King3370,120,47,1,4,11,41,476,145,57,167,621
King3371,76,34,4,3,5,43,376,111,55,110,487
King3372,47,35,3,9,8,29,189,112,49,82,301
King3373,49,40,5,11,6,78,250,201,100,89,451
King3378,99,62,4,6,10,58,393,135,78,161,528
King338,54,48,2,7,5,56,192,121,70,102,313
King3380,92,68,0,6,9,34,370,95,49,160,465
King3384,62,43,1,4,30,60,388,197,95,105,585
King3385,64,30,1,12,18,61,337,171,92,94,508
King3386,59,19,1,14,17,69,385,201,101,78,586
King3387,47,20,1,3,8,38,213,95,50,67,308
King3388,89,41,3,5,19,35,410,129,62,130,539
King3389,98,48,3,6,28,44,450,128,81,146,578
King339,0,0,0,1,1,0,4,1,2,0,5
King3391,127,66,0,1,6,36,464,98,43,193,562
King3393,55,27,1,3,1,18,173,36,23,82,209
King3395,33,23,3,8,5,25,110,68,41,56,178
King3396,45,44,1,10,4,18,245,90,33,89,335
King3397,18,27,1,2,2,20,142,66,25,45,208
King3398,66,50,1,6,11,51,380,126,69,116,506
King340,76,37,2,4,10,85,225,145,101,113,370
King3400,34,58,4,13,9,45,235,166,71,92,401
King3401,105,37,4,2,20,57,385,147,83,142,532
King3402,52,41,6,24,7,71,256,232,108,93,488
King3403,60,42,5,12,6,52,275,148,75,102,423
King3404,53,34,2,7,7,19,279,129,35,87,408
King3405,48,36,6,10,9,73,255,221,98,84,476
King3406,38,44,0,6,4,21,153,77,31,82,230
King3407,57,44,1,17,8,107,301,249,133,101,550
King3408,43,33,3,7,3,14,159,80,27,76,239
King3409,74,37,1,15,22,87,391,228,125,111,619
King3410,61,78,0,3,5,12,276,37,20,139,313
King3412,95,75,3,7,5,48,438,157,63,170,595
King3413,55,63,7,10,4,53,294,201,74,118,495
King3415,43,24,1,1,0,20,203,51,22,67,254
King3416,45,45,2,1,0,14,287,68,17,90,355
King3417,47,27,3,8,6,37,222,117,54,74,339
King3418,30,20,1,5,1,31,105,90,38,50,195
King342,96,114,0,2,5,18,393,51,25,210,444
King3420,36,41,2,4,5,37,219,78,48,77,297
King3422,65,37,1,2,9,43,323,114,55,102,437
King3424,84,35,1,0,3,5,342,17,9,119,359
King3437,31,19,0,4,7,27,113,74,38,50,187
King3438,40,38,1,3,2,34,194,91,40,78,285
King3439,71,45,2,5,17,24,346,89,48,116,435
King344,88,27,0,7,13,54,231,107,74,115,338
King3444,2,2,0,0,0,6,6,10,6,4,16
King3445,51,27,0,11,7,41,203,95,59,78,298
King3447,21,16,1,3,1,18,107,48,23,37,155
King3450,28,27,1,3,3,23,139,42,30,55,181
King3451,36,23,2,7,9,29,148,81,47,59,229
King3454,32,16,0,7,4,21,108,57,32,48,165
King3455,36,37,3,6,7,50,170,156,66,73,326
King3456,62,64,4,8,11,52,354,218,75,126,572
King3459,38,35,1,5,10,26,215,104,42,73,319
King346,35,32,0,1,7,7,173,29,15,67,202
King3461,56,62,4,22,13,96,311,315,135,118,626
King3464,107,64,3,4,10,52,439,163,69,171,602
King3468,24,31,1,5,8,62,121,153,76,55,274
King3472,38,38,5,10,6,76,204,243,97,76,447
King3474,39,49,5,13,4,87,230,262,109,88,492
King3475,49,31,3,5,7,58,181,117,73,80,298
King3476,20,33,1,1,1,16,118,46,19,53,164
King3477,12,15,0,9,1,16,68,53,26,27,121
King3478,22,36,3,9,2,58,104,151,72,58,255
King3479,69,48,0,6,7,19,462,76,32,117,538
King348,17,19,1,8,3,66,78,168,78,36,246
King3480,71,54,2,5,5,59,345,172,71,125,517
King3481,78,44,4,7,14,49,337,208,74,122,545
King3482,65,72,4,24,7,102,386,286,137,137,672
King3483,54,46,4,8,9,39,310,126,60,100,436
King3489,37,29,0,2,0,6,252,24,8,66,276
King3492,21,21,1,9,7,42,83,132,59,42,215
King3493,46,34,2,10,7,53,256,148,72,80,404
King3496,131,51,1,3,4,18,516,61,26,182,577
King3497,59,59,0,1,7,19,382,60,27,118,442
King3498,18,9,3,2,6,28,100,76,39,27,176
King3499,32,22,2,0,1,10,138,28,13,54,166
King3500,10,5,0,6,1,8,38,18,15,15,56
King3502,26,24,2,6,6,49,159,147,63,50,306
King3503,47,57,2,11,11,33,277,115,57,104,392
King3504,77,36,2,5,1,45,337,125,53,113,462
King3505,67,43,2,6,8,41,384,136,57,110,520
King3506,45,45,1,6,8,14,257,78,29,90,335
King3507,88,40,1,8,12,62,455,174,83,128,629
King3508,80,36,4,2,22,66,393,161,94,116,554
King3509,44,42,2,5,17,43,307,145,67,86,452
King3510,32,24,2,3,7,55,167,132,67,56,299
King3511,85,43,3,19,20,121,397,302,163,128,699
King3512,102,51,4,8,16,62,453,231,90,153,684
King3513,46,42,3,6,8,49,247,161,66,88,408
King3514,69,51,5,6,13,31,374,150,55,120,524
King3515,27,22,1,4,4,27,149,64,36,49,213
King3517,30,11,5,6,3,47,100,115,61,41,215
King3518,71,42,1,7,11,60,275,213,79,113,488
King3522,149,39,10,13,42,151,365,281,216,188,646
King3523,51,51,1,8,4,47,281,181,60,102,462
King3525,55,52,4,10,14,73,227,180,101,107,407
King3526,70,35,1,2,15,36,262,110,54,105,372
King3527,62,49,1,2,4,38,331,112,45,111,443
King3528,31,22,0,5,14,30,214,99,49,53,313
King3529,53,16,2,7,13,50,304,130,72,69,434
King3530,93,56,1,9,16,41,385,133,67,149,518
King3533,63,32,0,7,14,57,266,121,78,95,387
King3534,46,37,0,11,4,50,217,168,65,83,385
King3535,75,73,0,6,5,46,384,114,57,148,498
King3536,46,42,2,20,5,43,264,181,70,88,445
King3537,61,33,5,5,4,29,302,113,43,94,415
King3538,59,57,7,10,6,82,291,216,105,116,507
King3539,49,38,0,6,11,51,177,123,68,87,300
King354,65,39,7,6,1,35,215,110,49,104,325
King3545,69,11,5,6,15,44,228,114,70,80,342
King3547,129,53,1,8,14,54,592,134,77,182,726
King3548,23,15,0,4,5,10,159,46,19,38,205
King3551,22,22,0,8,11,55,128,142,74,44,270
King3552,54,60,2,3,5,40,369,124,50,114,493
King3553,53,62,3,6,5,29,317,84,43,115,401
King3554,103,25,2,10,20,60,236,120,92,128,356
King3555,42,28,0,7,3,55,222,128,65,70,350
King3556,59,69,4,7,7,19,265,64,37,128,329
King3557,12,15,5,0,5,24,69,84,34,27,153
King3558,50,42,0,11,7,15,272,119,33,92,391
King3559,142,73,2,15,51,84,506,190,152,215,696
King356,124,69,2,10,6,65,484,182,83,193,666
King3560,58,35,1,8,9,38,280,135,56,93,415
King3561,140,33,5,18,25,138,350,231,186,173,581
King3562,117,24,1,8,28,101,266,185,138,141,451
King3563,60,56,1,6,7,40,381,141,54,116,522
King3564,56,68,7,6,9,32,328,132,54,124,460
King3565,0,1,0,0,0,1,1,0,1,1,1
King3566,95,60,1,2,6,26,441,69,35,155,510
King3567,56,22,1,1,2,8,192,34,12,78,226
King3568,165,85,5,7,9,35,535,93,56,250,628
King3569,77,50,5,13,33,60,392,192,111,127,584
King357,75,61,3,8,2,28,293,95,41,136,388
King3570,73,82,0,2,0,7,422,49,9,155,471
King3571,35,55,0,0,6,11,279,21,17,90,300
King3572,69,55,0,4,10,33,383,111,47,124,494
King3573,24,60,0,0,0,3,257,15,3,84,272
King3574,30,15,1,5,3,39,168,114,48,45,282
King3575,64,53,1,6,5,46,347,134,58,117,481
King3576,71,56,2,5,10,65,266,170,82,127,436
King3578,43,35,1,8,0,30,233,87,39,78,320
King3579,26,19,0,1,0,17,115,54,18,45,169
King358,57,52,3,6,4,44,310,128,57,109,438
King3580,54,60,0,1,1,3,292,21,5,114,313
King3581,43,39,2,6,3,36,163,110,47,82,273
King3582,35,24,1,2,5,25,154,91,33,59,245
King3583,92,28,1,6,39,59,367,162,105,120,529
King3584,47,33,2,5,10,17,329,79,34,80,408
King3585,45,23,3,1,7,24,180,79,35,68,259
King3586,65,103,0,1,3,7,520,34,11,168,554
King3587,56,93,0,3,2,10,545,45,15,149,590
King3588,37,39,1,2,3,25,254,58,31,76,312
King3589,49,52,4,13,12,52,315,276,81,101,591
King3590,89,42,0,12,2,57,325,169,71,131,494
King3591,48,29,4,9,3,47,143,150,63,77,293
King3592,49,49,4,5,5,19,247,74,33,98,321
King3593,37,53,1,3,5,26,334,79,35,90,413
King3594,34,25,2,7,9,28,160,84,46,59,244
King3595,113,77,2,2,19,21,475,51,44,190,526
King3596,44,24,4,3,5,22,147,90,34,68,237
King3597,19,21,1,5,9,26,118,87,41,40,205
King3599,33,23,3,9,4,50,155,144,66,56,299
King36,104,71,1,5,18,33,401,111,57,175,512
King360,93,47,3,4,15,91,277,171,113,140,448
King3600,49,42,1,7,5,50,262,184,63,91,446
King3601,32,28,2,5,11,36,220,133,54,60,353
King3604,67,55,6,5,5,35,291,118,51,122,409
King3605,77,82,0,2,2,15,432,49,19,159,481
King3607,54,19,0,5,17,61,215,153,83,73,368
King3608,92,22,2,1,19,95,382,190,117,114,572
King3609,43,39,2,2,2,16,278,83,22,82,361
King361,39,36,0,4,9,30,198,85,43,75,283
King3610,19,7,1,1,2,39,83,101,43,26,184
King3611,76,67,0,12,21,67,331,202,100,143,533
King3612,27,27,0,3,0,15,101,52,18,54,153
King3613,30,18,7,1,1,37,108,90,46,48,198
King3614,9,6,0,0,1,3,39,11,4,15,50
King3616,1,0,0,0,0,0,1,0,0,1,1
King3617,88,81,0,2,4,21,467,66,27,169,533
King3618,18,23,0,2,1,33,151,61,36,41,212
King3619,49,48,5,5,2,24,248,93,36,97,341
King362,60,38,0,5,4,45,258,115,54,98,373
King3620,11,10,1,1,2,11,66,40,15,21,106
King3621,83,33,3,6,22,29,307,93,60,116,400
King3623,123,59,1,18,23,64,524,179,106,182,703
King3624,18,26,4,6,3,59,106,148,72,44,254
King3625,13,3,1,4,4,30,26,73,39,16,99
King3626,9,11,3,7,0,9,38,38,19,20,76
King3627,27,41,2,0,1,20,184,42,23,68,226
King3628,120,74,0,1,5,23,358,47,29,194,405
King3629,9,9,0,2,0,5,50,20,7,18,70
King363,36,34,0,2,1,14,181,61,17,70,242
King3630,15,8,0,1,3,5,60,22,9,23,82
King3631,2,0,0,0,0,1,9,3,1,2,12
King3632,30,20,1,1,0,3,195,8,5,50,203
King3633,20,37,0,3,7,32,179,86,42,57,265
King3634,44,25,1,1,10,25,268,87,37,69,355
King3635,50,49,1,16,11,74,285,198,102,99,483
King3636,81,82,1,4,2,15,495,52,22,163,547
King3637,84,65,4,4,8,21,377,74,37,149,451
King3638,90,54,2,4,10,41,478,170,57,144,648
King3639,65,53,0,0,1,2,259,15,3,118,274
King364,39,38,7,1,5,37,201,114,50,77,315
King3640,18,23,1,5,9,22,189,59,37,41,248
King3641,41,20,0,5,5,49,151,138,59,61,289
King3642,39,47,2,3,5,27,231,125,37,86,356
King3643,42,39,3,4,2,45,181,102,54,81,283
King3644,74,39,0,6,4,37,261,95,47,113,356
King3646,18,30,1,3,2,16,139,38,22,48,177
King3647,32,50,0,1,1,10,218,21,12,82,239
King3648,69,61,0,7,6,14,358,32,27,130,390
King3649,40,36,3,7,11,29,214,103,50,76,317
King3650,57,57,1,5,2,29,247,86,37,114,333
King3651,47,28,0,2,6,11,234,58,19,75,292
King3652,27,36,5,2,8,46,170,128,61,63,298
King3654,59,39,2,4,14,36,270,104,56,98,374
King3655,106,35,2,6,20,37,294,89,65,141,383
King3656,70,63,0,4,7,25,334,60,36,133,394
King3657,46,26,0,3,1,38,208,78,42,72,286
King3658,36,15,1,1,7,22,207,85,31,51,292
King3659,75,38,2,4,2,7,279,51,15,113,330
King366,70,52,3,4,12,50,306,135,69,122,441
King3660,39,38,7,12,10,23,172,80,52,77,252
King3661,62,61,0,10,2,41,276,138,53,123,414
King3663,59,26,3,5,8,63,189,124,79,85,313
King3664,72,101,2,1,7,24,455,97,34,173,552
King3665,85,52,0,5,9,23,407,59,37,137,466
King3666,45,37,0,0,1,9,213,30,10,82,243
King3667,54,27,4,20,10,54,315,177,88,81,492
King3668,42,38,2,5,6,24,238,63,37,80,301
King3669,38,46,0,2,4,8,301,26,14,84,327
King367,45,34,6,2,4,38,193,115,50,79,308
King3670,25,30,0,5,7,22,133,71,34,55,204
King3671,37,13,3,0,7,25,163,63,35,50,226
King3672,63,67,0,0,2,13,306,27,15,130,333
King3673,74,76,0,0,2,1,440,6,3,150,446
King3674,58,32,1,1,3,30,263,104,35,90,367
King3675,25,30,2,1,5,21,181,69,29,55,250
King3676,9,2,1,0,6,19,32,57,26,11,89
King3677,50,59,1,3,3,17,217,41,24,109,258
King3678,58,17,2,3,5,41,206,83,51,75,289
King3679,50,31,0,2,0,10,237,39,12,81,276
King368,51,34,1,1,1,15,194,53,18,85,247
King3680,55,16,1,4,9,29,221,82,43,71,303
King3681,43,28,1,8,6,28,197,96,43,71,293
King3682,36,60,1,0,0,3,297,27,4,96,324
King3683,32,26,1,3,10,29,154,77,43,58,231
King3684,36,10,0,3,4,12,140,42,19,46,182
King3685,47,48,0,0,2,6,232,16,8,95,248
King3686,83,35,0,3,9,28,323,63,40,118,386
King3687,40,10,1,1,4,17,140,46,23,50,186
King3688,6,2,0,0,0,1,18,1,1,8,19
King3689,31,63,0,1,3,9,308,26,13,94,334
King3690,8,1,1,0,0,1,25,7,2,9,32
King3691,46,54,1,3,8,32,264,106,44,100,370
King3692,0,0,0,0,0,0,0,0,0,0,0
King3693,0,0,0,0,0,0,0,0,0,0,0
King3694,10,15,0,0,0,2,67,5,2,25,72
King3695,57,32,1,4,7,32,277,93,44,89,370
King3696,6,10,0,0,0,1,29,3,1,16,32
King3698,3,3,0,1,0,5,24,17,6,6,41
King3699,60,75,0,2,6,6,460,32,14,135,492
King37,63,56,2,16,23,127,310,343,168,119,653
King370,72,109,1,8,13,11,309,62,33,181,371
King3700,176,39,4,2,36,40,401,83,82,215,484
King3701,36,69,1,1,2,6,392,28,10,105,420
King3702,61,62,0,0,2,11,371,34,13,123,405
King3703,37,50,0,7,12,32,251,146,51,87,397
King3704,21,26,1,5,1,22,100,88,29,47,188
King3705,60,29,0,0,2,8,275,27,10,89,302
King3706,14,8,0,5,0,8,58,59,13,22,117
King3707,98,29,2,7,27,90,228,152,126,127,380
King3708,45,67,1,1,1,8,362,30,11,112,392
King371,142,123,5,7,7,52,507,102,71,265,609
King3710,37,65,0,1,5,10,360,39,16,102,399
King3711,45,50,1,3,3,26,309,106,33,95,415
King3712,2,6,0,2,0,2,24,7,4,8,31
King3713,5,17,0,1,1,33,41,87,35,22,128
King3714,53,26,0,4,6,16,217,76,26,79,293
King3715,34,38,1,1,2,15,177,61,19,72,238
King3716,55,40,6,0,1,30,242,71,37,95,313
King3717,17,18,0,4,9,41,136,129,54,35,265
King3718,41,19,4,1,7,32,88,103,44,60,191
King3719,74,34,0,4,4,23,237,48,31,108,285
King3720,64,70,0,3,3,10,462,50,16,134,512
King3721,63,41,0,0,0,3,292,10,3,104,302
King373,38,32,1,3,4,62,143,146,70,70,289
King374,59,60,2,2,5,18,212,37,27,119,249
King377,78,75,5,7,3,50,345,130,65,153,475
King378,35,41,3,3,2,16,171,37,24,76,208
King379,66,39,0,18,17,123,295,300,158,105,595
King38,75,57,2,4,3,15,287,71,24,132,358
King381,67,62,1,2,8,37,276,99,48,129,375
King389,75,91,6,16,10,47,433,170,79,166,603
King392,50,46,0,1,0,10,202,42,11,96,244
King395,65,51,1,7,11,35,239,128,54,116,367
King396,131,122,1,8,10,54,485,119,73,253,604
King397,59,54,0,2,11,25,277,56,38,113,333
King400,88,62,0,9,6,31,326,92,46,150,418
King401,90,40,0,4,14,32,280,83,50,130,363
King402,63,57,0,4,2,43,234,88,49,120,322
King403,62,48,3,2,4,23,329,73,32,110,402
King404,80,46,3,7,11,48,279,137,69,126,416
King407,100,49,2,10,17,38,388,142,67,149,530
King408,28,19,0,2,9,22,110,62,33,47,172
King409,28,28,1,3,6,44,119,143,54,56,262
King41,79,69,3,9,5,58,320,172,75,148,492
King410,44,50,9,11,7,66,183,271,93,94,454
King411,81,58,5,8,10,106,246,277,129,139,523
King413,50,56,2,6,8,89,229,264,105,106,493
King415,22,14,4,3,4,28,94,92,39,36,186
King416,61,44,10,16,10,97,237,293,133,105,530
King417,26,25,1,2,1,35,106,86,39,51,192
King418,65,31,8,11,15,65,182,223,99,96,405
King419,36,39,6,18,3,66,150,210,93,75,360
King42,37,46,8,9,10,62,172,162,89,83,334
King421,111,85,4,5,17,49,425,162,75,196,587
King422,58,70,4,8,3,47,317,126,62,128,443
King423,58,46,1,0,11,22,258,49,34,104,307
King424,62,29,1,0,8,17,188,57,26,91,245
King426,105,72,1,2,4,43,478,99,50,177,577
King427,38,33,1,1,3,54,143,133,59,71,276
King430,40,19,0,3,6,35,130,86,44,59,216
King432,39,73,2,1,10,57,215,159,70,112,374
King437,53,28,0,6,5,21,164,66,32,81,230
King439,81,36,3,4,7,61,291,149,75,117,440
King442,54,44,0,11,9,27,289,124,47,98,413
King444,62,66,1,2,7,29,293,64,39,128,357
King45,86,69,1,10,5,74,314,149,90,155,463
King452,14,16,0,4,1,16,85,40,21,30,125
King453,100,60,2,7,5,60,397,159,74,160,556
King454,56,43,0,1,8,12,192,40,21,99,232
King455,84,52,2,9,8,60,341,163,79,136,504
King456,72,41,4,6,4,46,303,148,60,113,451
King46,43,34,0,5,3,43,134,86,51,77,220
King460,76,34,1,3,13,27,315,72,44,110,387
King461,39,29,3,4,10,51,148,143,68,68,291
King462,55,44,5,8,6,15,255,61,34,99,316
King465,36,29,0,1,1,15,159,43,17,65,202
King469,65,77,4,1,1,33,293,107,39,142,400
King47,77,58,8,6,3,39,210,171,56,135,381
King470,57,35,3,4,10,29,258,90,46,92,348
King471,84,84,0,8,2,45,398,120,55,168,518
King472,56,52,3,9,14,58,262,132,84,108,394
King473,67,68,2,8,7,19,341,96,36,135,437
King474,47,58,0,4,5,27,220,64,36,105,284
King475,32,20,1,6,10,24,149,51,41,52,200
King476,99,84,2,13,7,47,394,156,69,183,550
King479,0,0,0,0,0,7,4,7,7,0,11
King48,22,27,0,3,2,18,91,59,23,49,150
King481,44,31,1,6,9,41,170,121,57,75,291
King482,44,54,3,17,4,65,299,186,89,98,485
King485,94,60,1,10,4,32,325,101,47,154,426
King486,54,44,0,1,6,16,185,55,23,98,240
King487,27,24,2,11,2,76,125,218,91,51,343
King488,46,35,0,2,6,15,176,42,23,81,218
King489,92,57,1,17,7,47,261,119,72,149,380
King49,53,42,5,6,3,31,204,94,45,95,298
King492,42,23,1,5,7,20,161,82,33,65,243
King493,42,27,3,1,10,59,165,170,73,69,335
King494,75,57,1,1,3,17,312,49,22,132,361
King495,19,13,0,6,2,16,74,39,24,32,113
King498,20,14,1,3,1,32,68,64,37,34,132
King499,75,27,11,28,25,58,206,152,122,102,358
King50,39,28,3,5,4,49,159,123,61,67,282
King501,71,61,1,6,6,26,327,99,39,132,426
King502,76,70,3,15,11,48,328,166,77,146,494
King505,63,13,1,0,15,29,162,76,45,76,238
King51,41,51,1,2,3,46,188,114,52,92,302
King510,86,89,2,11,9,30,408,98,52,175,506
King514,58,36,1,6,28,45,262,121,80,94,383
King517,74,47,3,3,4,16,316,54,26,121,370
King518,57,20,0,0,8,18,168,42,26,77,210
King519,52,31,2,5,4,32,231,79,43,83,310
King520,93,76,3,21,38,82,397,248,144,169,645
King522,70,49,9,7,5,94,219,268,115,119,487
King525,80,44,2,9,13,66,294,145,90,124,439
King527,58,90,3,14,7,32,390,97,56,148,487
King528,58,18,1,11,16,95,137,153,123,76,290
King53,46,56,3,4,1,47,191,113,55,102,304
King530,45,14,0,2,7,37,153,64,46,59,217
King532,28,26,1,3,2,23,129,63,29,54,192
King533,39,4,0,7,15,46,161,116,68,43,277
King534,65,50,2,13,12,75,312,211,102,115,523
King535,66,48,0,9,5,34,377,118,48,114,495
King536,83,53,1,5,18,50,396,191,74,136,587
King537,59,24,4,1,16,28,188,66,49,83,254
King538,43,54,0,4,3,24,259,65,31,97,324
King539,48,28,3,4,3,39,234,97,49,76,331
King54,52,46,3,5,3,41,208,140,52,98,348
King543,72,61,2,10,12,46,332,147,70,133,479
King544,77,55,0,7,10,47,329,134,64,132,463
King545,28,34,0,1,5,27,163,70,33,62,233
King546,30,23,1,2,5,18,122,46,26,53,168
King547,41,31,3,3,9,34,171,92,49,72,263
King548,84,70,1,10,12,50,406,145,73,154,551
King55,38,33,1,3,2,27,182,113,33,71,295
King550,37,42,2,1,5,15,164,58,23,79,222
King554,50,39,1,1,4,17,264,76,23,89,340
King556,96,51,6,8,10,80,361,253,104,147,614
King558,26,45,0,1,4,18,173,37,23,71,210
King559,41,33,0,7,7,19,160,61,33,74,221
King560,60,64,0,6,3,34,286,74,43,124,360
King561,25,24,4,10,1,82,137,185,97,49,322
King562,63,56,1,1,0,21,256,53,23,119,309
King566,56,42,5,11,9,73,290,220,98,98,510
King568,11,25,0,0,0,2,57,5,2,36,62
King572,95,85,1,8,12,46,423,100,67,180,523
King573,130,83,2,14,6,75,396,156,97,213,552
King575,39,30,1,5,4,35,181,105,45,69,286
King576,37,45,1,7,4,28,183,97,40,82,280
King577,44,55,2,5,4,34,246,90,45,99,336
King578,85,53,0,3,2,42,230,106,47,138,336
King58,42,21,1,3,4,41,124,87,49,63,211
King581,108,57,4,7,5,65,359,138,81,165,497
King582,58,34,5,9,3,28,268,102,45,92,370
King583,53,33,2,11,4,51,193,116,68,86,309
King585,45,56,1,4,6,50,224,114,61,101,338
King586,85,28,3,5,4,57,243,118,69,113,361
King587,40,25,0,8,8,34,194,106,50,65,300
King588,35,37,1,2,7,20,163,62,30,72,225
King59,50,32,3,13,8,95,256,260,119,82,516
King590,81,69,7,6,6,70,316,182,89,150,498
King591,37,20,0,1,3,18,175,53,22,57,228
King592,16,15,0,1,1,18,78,44,20,31,122
King593,25,20,5,1,4,27,102,67,37,45,169
King594,44,33,0,3,4,39,177,98,46,77,275
King595,51,51,2,2,0,25,247,76,29,102,323
King596,61,41,3,10,9,49,237,152,71,102,389
King597,47,51,2,9,3,39,292,128,53,98,420
King598,49,33,0,4,6,27,219,84,37,82,303
King600,26,24,0,2,4,23,168,76,29,50,244
King601,84,61,3,8,7,50,378,139,68,145,517
King603,65,51,5,7,9,58,292,168,79,116,460
King605,74,44,0,15,8,25,254,66,48,118,320
King606,44,43,4,11,7,24,230,74,46,87,304
King607,44,39,4,9,3,47,205,149,63,83,354
King609,72,41,3,9,4,23,205,66,39,113,271
King610,65,63,2,6,10,64,237,136,82,128,373
King614,97,52,4,6,17,47,498,136,74,149,634
King615,79,54,2,1,7,40,352,112,50,133,464
King616,93,55,2,6,15,38,448,104,61,148,552
King618,75,27,0,3,25,46,287,100,74,102,387
King619,57,19,0,4,15,25,200,71,44,76,271
King62,70,58,3,7,9,65,295,187,84,128,482
King620,86,41,1,3,9,42,324,126,55,127,450
King622,45,26,0,0,7,23,242,75,30,71,317
King623,58,23,2,7,5,40,208,78,54,81,286
King624,126,58,3,8,27,55,461,166,93,184,627
King627,86,47,1,4,11,46,388,109,62,133,497
King628,110,65,0,4,17,56,403,133,77,175,536
King629,93,40,0,3,20,27,381,99,50,133,480
King63,20,17,0,6,5,32,95,75,43,37,170
King630,64,50,1,3,9,36,311,99,49,114,410
King631,62,58,3,7,16,38,333,129,64,120,462
King632,68,64,1,1,12,39,295,90,53,132,385
King633,73,42,0,4,13,36,290,99,53,115,389
King636,83,46,2,2,13,39,307,91,56,129,398
King638,67,32,0,3,17,50,310,136,70,99,446
King639,58,24,1,1,9,40,232,91,51,82,323
King64,38,20,1,5,3,19,147,83,28,58,230
King641,76,24,1,1,15,30,220,66,47,100,286
King642,56,27,3,3,12,34,261,81,52,83,342
King643,32,18,1,8,11,11,145,67,31,50,212
King644,97,45,2,14,16,51,442,162,83,142,604
King645,25,7,0,3,12,15,117,50,30,32,167
King646,74,32,2,8,17,39,288,125,66,106,413
King647,52,41,3,15,11,69,184,275,98,93,459
King648,51,63,0,5,4,20,305,62,29,114,367
King649,65,45,1,13,9,72,362,221,95,110,583
King65,37,27,2,2,3,25,130,66,32,64,196
King650,70,40,0,3,5,12,253,44,20,110,297
King652,54,33,0,1,3,11,180,30,15,87,210
King653,90,61,2,6,9,12,296,55,29,151,351
King654,79,62,1,8,2,33,314,76,44,141,390
King655,136,108,0,3,3,25,498,100,31,244,598
King658,53,41,0,7,12,26,239,70,45,94,309
King659,51,39,5,12,1,33,232,131,51,90,363
King660,141,84,0,3,1,32,543,85,36,225,628
King662,75,33,7,9,11,95,258,223,122,108,481
King665,47,50,2,7,12,16,273,65,37,97,338
King667,100,81,0,0,3,21,341,56,24,181,397
King668,23,27,0,7,1,19,111,78,27,50,189
King67,39,59,4,6,1,38,201,110,49,98,311
King671,66,67,3,23,7,55,383,262,88,133,645
King676,52,51,0,10,13,33,287,112,56,103,399
King677,89,57,0,5,12,30,332,100,47,146,432
King682,55,43,4,5,5,41,209,125,55,98,334
King684,16,17,3,4,1,46,93,117,54,33,210
King686,61,76,4,5,9,19,306,66,37,137,372
King687,59,76,2,11,4,13,338,55,30,135,393
King688,43,29,1,14,9,64,143,162,88,72,305
King689,91,57,2,15,17,43,324,106,77,148,430
King69,27,28,5,4,3,38,118,100,50,55,218
King690,52,51,0,5,2,28,311,81,35,103,392
King692,87,71,1,2,9,25,349,95,37,158,444
King694,64,49,2,7,10,51,297,123,70,113,420
King695,81,46,4,5,8,33,328,107,50,127,435
King696,123,76,3,12,19,54,456,146,88,199,602
King697,69,62,4,7,22,79,307,214,112,131,521
King699,121,95,6,8,21,70,504,179,105,216,683
King70,56,43,4,10,1,59,252,191,74,99,443
King701,94,75,1,3,2,53,344,122,59,169,466
King702,3,0,0,0,1,7,24,18,8,3,42
King703,70,41,5,7,10,52,245,178,74,111,423
King705,84,83,1,5,4,29,412,84,39,167,496
King708,36,22,0,7,17,36,167,89,60,58,256
King709,14,14,3,2,3,64,71,147,72,28,218
King710,52,39,0,2,3,30,205,69,35,91,274
King711,48,35,3,6,2,26,214,57,37,83,271
King717,63,61,0,9,17,83,320,255,109,124,575
King719,25,24,0,3,2,24,104,69,29,49,173
King72,60,45,4,11,12,56,225,161,83,105,386
King723,103,97,0,6,1,41,424,119,48,200,543
King729,90,85,0,7,8,60,482,129,75,175,611
King73,61,68,4,5,10,57,271,145,76,129,416
King733,68,65,2,2,4,42,385,112,50,133,497
King734,79,64,1,6,7,32,361,87,46,143,448
King735,50,40,2,0,0,10,190,32,12,90,222
King738,44,48,2,1,1,31,240,76,35,92,316
King739,76,72,2,6,10,23,290,60,41,148,350
King74,71,61,0,7,9,51,240,131,67,132,371
King741,44,23,5,5,6,74,154,179,90,67,333
King742,31,34,1,0,2,27,114,76,30,65,190
King749,81,14,0,3,21,45,263,125,69,95,388
King750,68,25,2,2,25,58,315,182,87,93,497
King751,75,28,2,7,18,67,252,162,94,103,414
King752,49,24,0,2,27,66,237,147,95,73,384
King753,44,61,2,9,3,44,246,155,58,105,401
King754,90,71,3,7,13,43,411,114,66,161,525
King755,48,12,0,1,2,27,161,59,30,60,220
King756,102,59,5,6,21,51,465,146,83,161,611
King757,50,23,0,8,10,28,253,73,46,73,326
King758,63,35,0,2,6,19,192,40,27,98,232
King759,60,25,0,8,11,34,225,78,53,85,303
King761,60,10,0,2,6,32,213,78,40,70,291
King762,49,12,0,0,7,12,146,43,19,61,189
King763,43,15,0,1,8,24,180,57,33,58,237
King765,142,30,5,8,47,62,351,173,122,172,524
King766,59,14,1,3,6,20,195,52,30,73,247
King767,43,21,0,0,2,18,168,46,20,64,214
King768,45,25,0,2,3,28,183,52,33,70,235
King769,102,27,1,3,25,42,359,89,71,129,448
King770,43,27,1,4,7,25,171,63,37,70,234
King771,41,16,1,3,10,14,136,42,28,57,178
King773,37,30,1,4,13,26,181,70,44,67,251
King774,82,19,2,10,14,29,307,74,55,101,381
King775,76,27,0,5,14,34,292,88,53,103,380
King776,64,19,1,4,10,26,205,60,41,83,265
King777,80,35,1,2,15,38,285,104,56,115,389
King778,63,18,0,4,8,15,209,63,27,81,272
King779,82,19,1,6,15,46,308,115,68,101,423
King78,55,30,3,5,2,38,159,105,48,85,264
King780,71,12,0,2,11,32,244,60,45,83,304
King781,42,8,0,0,8,11,147,34,19,50,181
King782,66,32,1,10,18,23,291,100,52,98,391
King784,64,26,2,2,9,24,244,79,37,90,323
King785,58,27,0,1,3,30,221,75,34,85,296
King786,40,11,2,5,5,16,149,46,28,51,195
King787,47,22,0,6,7,18,198,64,31,69,262
King788,59,19,0,1,16,16,233,42,33,78,275
King789,119,28,0,0,17,52,355,124,69,147,479
King790,33,17,2,6,7,18,136,60,33,50,196
King791,36,19,2,6,3,14,158,39,25,55,197
King792,51,9,1,5,7,30,177,64,43,60,241
King793,97,27,3,5,23,54,357,117,85,124,474
King794,73,18,0,6,15,20,249,71,41,91,320
King795,106,22,2,5,14,26,329,70,47,128,399
King796,107,44,2,0,5,50,350,96,57,151,446
King797,62,41,3,3,4,21,228,58,31,103,286
King798,79,58,8,16,7,84,322,246,115,137,568
King799,38,36,3,2,4,37,140,86,46,74,226
King80,33,45,2,7,9,45,193,180,63,78,373
King800,50,84,2,10,8,49,344,136,69,134,480
King801,30,33,1,5,5,42,151,134,53,63,285
King802,45,62,0,2,10,24,265,55,36,107,320
King804,98,87,1,6,6,43,514,171,56,185,685
King805,97,68,1,6,5,41,366,116,53,165,482
King807,72,63,4,18,16,53,339,151,91,135,490
King809,6,6,0,0,2,1,27,6,3,12,33
King81,53,35,4,12,3,43,146,141,62,88,287
King810,44,38,1,8,2,42,212,123,53,82,335
King812,61,40,3,7,6,44,235,99,60,101,334
King815,42,47,1,8,9,21,214,67,39,89,281
King816,85,37,5,10,13,67,335,207,95,122,542
King818,77,92,1,10,1,51,395,140,63,169,535
King819,51,60,2,2,4,9,270,42,17,111,312
King82,50,29,0,9,2,54,161,134,65,79,295
King820,47,50,3,3,4,16,218,82,26,97,300
King822,53,68,2,14,12,92,304,234,120,121,538
King823,64,34,11,21,10,93,238,306,135,98,544
King824,61,51,3,3,8,43,270,131,57,112,401
King825,34,36,0,1,5,18,119,89,24,70,208
King83,41,54,4,5,4,52,167,133,65,95,300
King832,56,37,1,10,5,26,211,66,42,93,277
King834,50,52,1,11,17,51,266,190,80,102,456
King835,88,44,1,12,6,42,302,149,61,132,451
King839,26,19,3,5,3,47,93,146,58,45,239
King840,65,21,3,9,25,67,343,185,104,86,528
King842,89,56,5,14,18,59,343,191,96,145,534
King844,83,49,2,7,11,37,296,71,57,132,367
King848,64,52,2,8,8,35,248,98,53,116,346
King849,54,41,0,2,19,34,216,84,55,95,300
King851,64,40,2,10,10,48,283,138,70,104,421
King852,60,35,3,3,7,39,230,100,52,95,330
King853,33,18,2,4,16,46,141,112,68,51,253
King854,53,47,2,8,15,46,228,132,71,100,360
King855,53,36,2,4,7,39,219,89,52,89,308
King857,114,66,2,9,31,68,375,184,110,180,559
King858,40,49,2,1,4,38,202,137,45,89,339
King859,65,53,2,5,7,45,241,125,59,118,366
King861,94,93,5,3,8,21,425,94,37,187,519
King864,45,41,2,10,7,30,166,93,49,86,259
King866,58,54,2,3,2,16,256,71,23,112,327
King868,65,68,2,3,8,55,352,158,68,133,510
King869,66,63,5,13,3,53,297,168,74,129,465
King870,79,67,3,2,14,40,336,119,59,146,455
King875,91,98,1,1,4,12,387,48,18,189,435
King878,112,64,5,4,8,48,411,124,65,176,535
King88,38,37,0,0,1,12,147,32,13,75,179
King880,27,33,0,5,4,29,149,78,38,60,227
King881,47,37,1,14,12,73,171,263,100,84,434
King885,49,54,4,10,9,101,228,325,124,103,553
King886,56,55,2,8,10,71,241,228,91,111,469
King887,74,51,2,7,3,66,286,225,78,125,511
King888,41,26,2,6,2,2,179,29,12,67,208
King8888,2,1,0,0,0,1,30,9,1,3,39
King89,42,25,5,6,4,45,160,120,60,67,280
King893,57,61,1,3,5,29,291,112,38,118,403
King895,61,65,2,1,2,11,300,40,16,126,340
King897,64,56,0,6,3,13,298,55,22,120,353
King898,52,26,0,3,5,10,190,49,18,78,239
King9,29,27,1,6,1,22,138,60,30,56,198
King900,53,51,3,8,6,25,202,76,42,104,278
King901,82,69,2,13,22,109,415,276,146,151,691
King903,40,66,0,4,3,12,187,34,19,106,221
King909,104,62,1,9,20,78,488,214,108,166,702
King91,27,29,1,5,10,36,149,75,52,56,224
King910,56,70,2,13,2,50,275,185,67,126,460
King911,77,55,1,8,3,62,276,121,74,132,397
King912,8,8,0,1,1,15,48,44,17,16,92
King913,97,55,0,5,1,33,339,80,39,152,419
King914,85,31,0,3,11,41,289,102,55,116,391
King917,63,59,2,10,8,17,326,77,37,122,403
King918,58,56,3,4,4,53,282,132,64,114,414
King919,70,59,4,5,14,79,277,224,102,129,501
King92,91,71,0,7,11,35,391,84,53,162,475
King920,45,35,2,5,6,17,191,44,30,80,235
King921,55,18,1,0,2,31,150,66,34,73,216
King924,79,61,1,2,17,20,243,49,40,140,292
King925,46,32,1,3,2,32,175,91,38,78,266
King926,94,84,4,9,12,52,446,194,77,178,640
King927,56,51,6,5,9,42,277,138,62,107,415
King93,104,153,3,3,6,27,431,73,39,257,504
King932,28,22,1,5,9,61,162,184,76,50,346
King935,58,69,2,3,10,29,347,95,44,127,442
King936,41,65,0,10,4,18,259,76,32,106,335
King937,39,19,1,2,1,26,116,50,30,58,166
King938,18,24,0,1,4,11,155,28,16,42,183
King939,57,48,4,5,10,38,251,93,57,105,344
King94,62,48,0,5,6,51,227,116,62,110,343
King940,53,28,3,2,15,45,203,108,65,81,311
King941,45,29,4,4,3,17,216,53,28,74,269
King942,61,36,0,4,5,38,250,95,47,97,345
King944,58,41,1,3,4,15,191,73,23,99,264
King945,55,40,4,8,3,40,215,123,55,95,338
King947,63,40,3,5,12,35,237,70,55,103,307
King948,25,19,0,1,1,13,138,53,15,44,191
King949,59,55,0,4,6,29,258,81,39,114,339
King950,34,29,2,5,7,27,227,98,41,63,325
King951,46,37,0,7,5,26,212,62,38,83,274
King952,27,24,4,3,6,21,153,70,34,51,223
King953,106,73,0,10,13,59,456,153,82,179,609
King954,104,47,0,8,13,94,365,215,115,151,580
King956,109,80,0,9,4,31,456,104,44,189,560
King957,45,28,1,0,0,16,158,54,17,73,212
King958,37,37,1,3,5,17,174,103,26,74,277
King962,34,25,0,6,3,15,154,40,24,59,194
King964,51,40,1,4,6,38,279,116,49,91,395
King965,131,73,0,7,6,52,410,112,65,204,522
King967,71,49,2,6,4,25,276,70,37,120,346
King970,30,19,0,2,1,17,132,56,20,49,188
King971,78,56,2,2,11,43,296,139,58,134,435
King973,81,50,1,6,4,46,275,120,57,131,395
King975,76,74,1,2,1,65,415,167,69,150,582
King978,64,52,2,0,0,20,238,82,22,116,320
King979,28,29,0,4,1,22,136,66,27,57,202
King98,44,35,1,5,13,42,243,109,61,79,352
King980,20,25,1,2,3,9,157,30,15,45,187
King981,129,68,7,13,10,100,422,204,130,197,626
King983,99,79,1,13,8,59,378,162,81,178,540
King984,34,22,2,7,10,35,141,70,54,56,211
King985,52,21,4,2,4,47,147,91,57,73,238
King986,87,39,1,7,8,53,353,142,69,126,495
King988,41,40,1,6,3,18,227,96,28,81,323
King989,70,42,1,4,5,62,412,161,72,112,573
King99,33,15,0,5,9,10,131,62,24,48,193
King990,38,31,0,2,3,24,223,59,29,69,282
King991,67,59,1,6,4,25,345,97,36,126,442
King992,35,26,1,3,4,20,129,57,28,61,186
King993,79,68,6,5,13,52,326,178,76,147,504
King994,47,44,0,3,9,31,252,110,43,91,362
King995,84,58,4,6,13,46,403,151,69,142,554
King996,61,47,2,5,3,49,278,143,59,108,421
King997,110,78,3,3,12,32,464,127,50,188,591
King998,41,24,0,3,2,29,180,72,34,65,252
King999,89,76,1,3,5,48,413,93,57,165,506
Kitsap100001,72,76,5,6,10,47,274,126,68,148,400
Kitsap100002,37,66,0,13,6,35,179,107,54,103,286
Kitsap100003,76,101,3,16,7,74,384,232,100,177,616
Kitsap100005,56,96,1,6,5,43,294,124,55,152,418
Kitsap100006,38,98,0,0,0,0,237,141,0,136,378
Kitsap100007,0,0,0,0,0,0,6,2,0,0,8
Kitsap100012,25,28,1,3,3,11,110,50,18,53,160
Kitsap100013,73,124,4,8,5,60,345,177,77,197,522
Kitsap100015,61,126,3,19,11,95,394,273,128,187,667
Kitsap100016,24,35,0,1,3,15,117,70,19,59,187
Kitsap100022,59,79,5,9,3,54,254,161,71,138,415
Kitsap100029,68,124,4,15,10,76,318,212,105,192,530
Kitsap100030,97,55,3,15,15,90,286,228,123,152,514
Kitsap100031,57,36,1,2,12,46,215,131,61,93,346
Kitsap100032,45,22,0,2,1,19,63,38,22,67,101
Kitsap100037,96,104,6,18,27,144,407,381,195,200,788
Kitsap100040,81,115,6,20,13,88,344,210,127,196,554
Kitsap100041,120,70,2,6,9,68,311,176,85,190,487
Kitsap100046,88,107,4,14,11,86,382,229,115,195,611
Kitsap100051,11,10,2,2,1,10,26,28,15,21,54
Kitsap100052,85,62,3,5,4,64,285,156,76,147,441
Kitsap100053,123,146,10,13,14,121,486,355,158,269,841
Kitsap100054,61,55,4,16,5,52,183,165,77,116,348
Kitsap100056,100,106,4,18,5,93,347,224,120,206,571
Kitsap100058,130,98,3,13,13,80,390,253,109,228,643
Kitsap100065,105,104,8,24,25,130,363,333,187,209,696
Kitsap100066,117,78,11,20,3,85,322,274,119,195,596
Kitsap100067,113,105,6,19,11,121,349,341,157,218,690
Kitsap100073,56,55,5,11,8,59,193,166,83,111,359
Kitsap100082,0,0,0,0,0,0,0,0,0,0,0
Kitsap100083,108,120,6,25,21,124,412,339,176,228,751
Kitsap100084,6,22,4,1,7,31,66,85,43,28,151
Kitsap100085,2,5,0,0,3,14,26,25,17,7,51
Kitsap100086,0,0,0,0,0,0,7,2,0,0,9
Kitsap100087,19,33,2,3,1,28,90,82,34,52,172
Kitsap100088,10,17,1,3,2,25,66,53,31,27,119
Kitsap100090,17,16,0,0,0,0,68,60,0,33,128
Kitsap100095,99,122,6,19,7,110,361,313,142,221,674
Kitsap100099,9,16,1,2,1,14,44,31,18,25,75
Kitsap100101,23,56,3,23,10,46,169,231,82,79,400
Kitsap100102,87,89,9,24,21,130,311,386,184,176,697
Kitsap100103,57,59,7,11,18,84,245,252,120,116,497
Kitsap100105,88,99,10,41,22,172,430,457,245,187,887
Kitsap100106,72,86,10,21,19,160,294,434,210,158,728
Kitsap100107,0,0,0,0,0,0,0,0,0,0,0
Kitsap100109,14,22,2,5,3,32,108,110,42,36,218
Kitsap100110,46,53,7,15,11,87,207,295,120,99,502
Kitsap100111,66,84,2,30,10,107,239,288,149,150,527
Kitsap100112,62,55,7,7,9,90,207,223,113,117,430
Kitsap100113,43,39,7,10,5,84,185,197,106,82,382
Kitsap100114,0,0,0,0,0,0,0,0,0,0,0
Kitsap100120,65,72,5,14,28,136,231,323,183,137,554
Kitsap100121,114,67,13,25,23,131,321,344,192,181,665
Kitsap100122,39,43,3,12,3,90,136,236,108,82,372
Kitsap100125,85,100,9,16,13,105,299,304,143,185,603
Kitsap100126,58,58,5,14,14,82,215,194,115,116,409
Kitsap100127,85,89,3,27,16,117,370,393,163,174,763
Kitsap100128,106,96,8,20,15,146,368,357,189,202,725
Kitsap100129,40,33,1,5,5,55,165,155,66,73,320
Kitsap100130,65,51,4,21,13,91,231,210,129,116,441
Kitsap100131,27,20,0,12,0,48,121,141,60,47,262
Kitsap100135,50,39,5,14,15,87,172,230,121,89,402
Kitsap100137,39,65,2,7,8,79,202,252,96,104,454
Kitsap100139,36,36,6,8,8,66,149,165,88,72,314
Kitsap100140,71,56,5,6,9,117,253,296,137,127,549
Kitsap100141,78,100,6,22,21,66,384,308,115,178,692
Kitsap100142,72,64,2,13,22,91,246,222,128,136,468
Kitsap100143,111,102,11,21,12,106,353,320,150,213,673
Kitsap100144,32,67,8,13,9,94,217,212,124,99,429
Kitsap100146,64,62,7,11,14,75,251,214,107,126,465
Kitsap100147,102,79,8,22,21,141,379,389,192,181,768
Kitsap100148,72,96,11,20,27,89,401,316,147,168,717
Kitsap100149,63,83,7,22,16,99,324,295,144,146,619
Kitsap100150,64,62,14,16,13,99,256,261,142,126,517
Kitsap100151,51,51,3,16,6,78,179,206,103,102,385
Kitsap100152,104,89,7,27,18,151,387,409,203,193,796
Kitsap100153,81,87,2,23,24,152,297,420,201,168,717
Kitsap100155,95,97,14,24,16,213,323,542,267,192,865
Kitsap100157,88,86,9,14,11,183,228,446,217,174,674
Kitsap100158,23,21,3,1,5,39,70,112,48,44,182
Kitsap100159,71,45,5,19,6,73,194,159,103,116,353
Kitsap100160,136,83,12,22,16,138,369,350,188,219,719
Kitsap100161,116,129,8,23,23,164,422,480,218,245,902
Kitsap100162,92,80,8,18,27,140,319,414,193,172,733
Kitsap100163,69,56,11,15,19,116,235,271,161,125,506
Kitsap100164,106,101,10,19,25,134,376,366,188,207,742
Kitsap100165,70,58,4,19,7,82,222,218,112,128,440
Kitsap100170,64,61,0,18,11,76,217,211,105,125,428
Kitsap100173,85,65,9,21,11,92,313,261,133,150,574
Kitsap100175,82,85,10,27,7,113,310,313,157,167,623
Kitsap100200,37,62,8,16,8,59,178,187,91,99,365
Kitsap100201,65,95,4,8,6,101,271,257,119,160,528
Kitsap100202,76,112,8,26,13,118,343,360,165,188,703
Kitsap100203,34,45,7,18,11,43,198,186,79,79,384
Kitsap100204,91,105,6,17,8,107,318,298,138,196,616
Kitsap100205,134,66,12,28,37,165,377,389,242,200,766
Kitsap100206,0,0,0,0,0,0,0,0,0,0,0
Kitsap100207,90,113,10,28,19,114,397,371,171,203,768
Kitsap100208,0,0,0,0,0,0,0,0,0,0,0
Kitsap100209,0,0,0,0,0,0,0,0,0,0,0
Kitsap100210,48,75,7,15,24,75,265,334,121,123,599
Kitsap100211,87,67,7,16,15,106,270,312,144,154,582
Kitsap100212,122,116,9,25,15,148,428,408,197,238,836
Kitsap100213,62,87,7,22,8,134,266,394,171,149,660
Kitsap100214,43,61,9,16,15,138,222,344,178,104,566
Kitsap100215,0,0,0,0,0,0,0,0,0,0,0
Kitsap100216,30,39,1,9,4,55,131,201,69,69,332
Kitsap100217,52,67,7,20,15,97,211,276,139,119,487
Kitsap100218,71,87,10,34,4,127,344,350,175,158,694
Kitsap100219,49,65,6,18,6,140,237,348,170,114,585
Kitsap100220,69,48,3,24,19,104,238,245,150,117,483
Kitsap100221,115,126,10,13,17,126,430,350,166,241,780
Kitsap100222,38,65,3,13,10,79,139,242,105,103,381
Kitsap100223,74,70,4,18,5,138,290,324,165,144,614
Kitsap100227,71,89,4,18,7,174,290,467,203,160,757
Kitsap100230,81,86,13,25,9,145,327,487,192,167,814
Kitsap100232,70,79,12,39,16,196,334,493,263,149,827
Kitsap100240,85,89,2,7,19,82,349,241,110,174,590
Kitsap100241,56,84,4,17,11,110,250,262,142,140,512
Kitsap100242,68,69,7,29,13,94,271,286,143,137,557
Kitsap100245,57,61,7,12,7,82,226,267,108,118,493
Kitsap100246,68,105,3,20,16,140,387,432,179,173,819
Kitsap100247,71,100,9,16,7,122,314,352,154,171,666
Kitsap100250,83,99,12,12,15,134,330,389,173,182,719
Kitsap100252,62,80,3,15,11,112,255,322,141,142,577
Kitsap100255,79,73,5,9,23,79,283,246,116,152,529
Kitsap100257,124,107,12,27,30,170,434,487,239,231,921
Kitsap100258,59,69,8,17,5,109,250,323,139,128,573
Kitsap100259,72,80,9,20,11,108,297,306,148,152,603
Kitsap100260,68,104,10,23,15,141,312,427,189,172,739
Kitsap100263,65,97,11,29,10,185,310,509,235,162,819
Kitsap100265,59,70,3,21,8,80,255,284,112,129,539
Kitsap100266,70,98,8,11,12,139,333,376,170,168,709
Kitsap100267,84,97,3,18,7,81,298,269,109,181,567
Kitsap100269,61,52,9,18,5,96,228,245,128,113,473
Kitsap100270,105,116,10,21,15,131,336,366,177,221,702
Kitsap100271,47,50,4,19,5,69,187,185,97,97,372
Kitsap100272,85,80,11,18,16,131,320,396,176,165,716
Kitsap100275,40,50,3,10,4,65,167,168,82,90,335
Kitsap100278,4,3,0,4,0,4,15,12,8,7,27
Kitsap100279,46,52,4,10,6,64,187,224,84,98,411
Kitsap100280,26,25,4,6,2,58,76,135,70,51,211
Kitsap100281,64,61,3,10,7,128,205,343,148,125,548
Kitsap100282,77,89,7,13,12,168,266,402,200,166,668
Kitsap100283,0,0,0,0,0,0,5,7,0,0,12
Kitsap100285,18,15,3,1,0,50,60,122,54,33,182
Kitsap100292,98,64,4,15,13,140,321,347,172,162,668
Kitsap100293,0,0,0,0,0,0,0,0,0,0,0
Kitsap100294,0,0,0,0,0,0,0,0,0,0,0
Kitsap100295,58,39,3,15,15,75,197,225,108,97,422
Kitsap100296,9,2,0,4,1,16,42,61,21,11,103
Kitsap100297,0,0,0,0,0,0,0,0,0,0,0
Kitsap100301,243,252,6,10,19,55,965,144,90,495,1109
Kitsap100302,233,141,2,3,28,56,731,113,89,374,844
Kitsap100304,306,213,2,14,30,50,984,164,96,519,1148
Kitsap100305,147,66,4,12,16,47,482,107,79,213,589
Kitsap100310,152,111,1,6,17,39,526,91,63,263,617
Kitsap100312,224,141,2,14,41,59,787,145,116,365,932
Kitsap100314,141,107,2,10,14,42,481,92,68,248,573
Kitsap100315,252,151,2,10,33,50,834,138,95,403,972
Kitsap100317,97,111,0,1,8,27,451,59,36,208,510
Kitsap100318,177,113,2,1,27,46,694,123,76,290,817
Kitsap100320,129,126,1,4,12,32,510,92,49,255,602
Kitsap100321,63,67,1,3,3,32,287,64,39,130,351
Kitsap100322,114,101,4,4,12,28,454,90,48,215,544
Kitsap100325,122,105,0,5,13,38,490,128,56,227,618
Kitsap100328,164,123,3,8,15,33,515,86,59,287,601
Kitsap100330,169,133,1,5,23,44,639,112,73,302,751
Kitsap100332,89,90,0,3,18,35,341,90,56,179,431
Kitsap100333,157,88,2,7,17,39,472,106,65,245,578
Kitsap100335,179,118,0,2,20,58,613,133,80,297,746
Kitsap100336,121,95,4,4,9,26,454,75,43,216,529
Kitsap100340,143,57,0,3,26,42,449,92,71,200,541
Kitsap100345,200,165,0,12,27,85,733,158,124,365,891
Kitsap100401,79,135,9,19,18,129,505,414,175,214,919
Kitsap100403,101,102,7,19,23,84,363,224,133,203,587
Kitsap100404,144,94,7,17,28,113,472,284,165,238,756
Kitsap100405,185,152,10,21,26,126,633,297,183,337,930
Kitsap100406,158,125,12,4,31,133,558,359,180,283,917
Kitsap100407,104,70,3,16,13,90,333,215,122,174,548
Kitsap100410,100,97,13,23,18,93,383,295,147,197,678
Kitsap100412,105,96,15,35,26,129,417,356,205,201,773
Kitsap100413,64,61,7,14,19,84,277,199,124,125,476
Kitsap100415,65,80,3,21,14,89,245,204,127,145,449
Kitsap100416,189,187,8,21,21,155,620,400,205,376,1020
Kitsap100417,174,124,4,12,26,149,512,284,191,298,796
Kitsap100418,12,16,0,0,0,0,101,7,0,28,108
Kitsap100419,95,84,3,13,17,103,336,222,136,179,558
Kitsap100420,186,207,3,10,19,80,673,171,112,393,844
Kitsap100421,72,100,1,13,9,71,348,197,94,172,545
Kitsap100422,124,139,14,15,21,100,451,274,150,263,725
Kitsap100423,117,139,6,11,17,133,472,311,167,256,783
Kitsap100425,99,90,14,15,20,163,371,407,212,189,778
Kitsap100426,30,39,3,13,8,44,120,131,68,69,251
Kitsap100427,82,92,8,10,11,129,323,340,158,174,663
Kitsap100430,105,122,3,12,25,90,432,209,130,227,641
Kitsap100435,86,90,5,15,17,86,311,238,123,176,549
Kitsap100440,70,76,11,15,18,100,286,298,144,146,584
Kitsap100441,46,71,4,13,21,83,239,215,121,117,454
Kitsap100442,139,132,3,26,36,165,493,390,230,271,883
Kitsap100445,114,96,11,19,24,176,433,418,230,210,851
Kitsap100450,98,119,3,21,19,111,360,280,154,217,640
Kitsap100453,83,146,12,12,12,117,433,286,153,229,719
Kitsap100454,66,96,8,18,5,78,313,210,109,162,523
Kitsap100455,94,94,6,17,13,137,357,381,173,188,738
Kitsap100458,124,147,13,16,12,114,491,316,155,271,807
Kitsap100460,82,133,5,6,5,59,438,159,75,215,597
Kitsap100461,72,87,0,5,4,37,274,109,46,159,383
Kitsap100463,116,93,4,8,10,57,385,156,79,209,541
Kitsap100464,106,86,4,7,10,74,332,180,95,192,512
Kittitas1,27,29,2,4,5,66,75,145,77,56,220
Kittitas11,10,22,0,0,0,0,55,26,0,32,81
Kittitas12,11,22,1,2,1,21,67,52,25,33,119
Kittitas13,17,24,1,2,1,6,83,31,10,41,114
Kittitas14,12,16,1,3,2,8,55,52,14,28,107
Kittitas15,7,24,0,4,4,17,71,60,25,31,131
Kittitas16,12,26,2,5,0,9,90,38,16,38,128
Kittitas17,25,30,2,3,2,32,135,88,39,55,223
Kittitas18,22,21,1,5,1,18,128,69,25,43,197
Kittitas19,34,33,3,2,3,13,113,47,21,67,160
Kittitas2,23,18,3,4,3,50,79,104,60,41,183
Kittitas20,23,17,2,2,2,13,101,38,19,40,139
Kittitas21,31,25,1,4,4,32,126,68,41,56,194
Kittitas22,25,19,3,7,7,35,116,125,52,44,241
Kittitas23,32,61,2,13,6,66,222,201,87,93,423
Kittitas24,43,83,3,6,5,58,308,178,72,126,486
Kittitas25,7,12,0,0,0,0,82,23,0,19,105
Kittitas26,44,116,3,8,8,52,345,217,71,160,562
Kittitas27,12,32,0,0,0,0,84,43,0,44,127
Kittitas28,23,29,0,2,1,28,111,83,31,52,194
Kittitas29,31,42,3,4,2,48,144,135,57,73,279
Kittitas3,18,10,0,2,3,24,48,50,29,28,98
Kittitas30,36,33,2,6,10,44,140,140,62,69,280
Kittitas31,80,46,5,20,14,107,280,284,146,126,564
Kittitas32,13,29,3,1,3,40,86,97,47,42,183
Kittitas33,14,15,1,3,2,54,68,142,60,29,210
Kittitas34,42,34,3,7,8,77,153,205,95,76,358
Kittitas35,20,21,0,1,2,52,84,117,55,41,201
Kittitas36,29,34,3,10,5,83,159,241,101,63,400
Kittitas37,41,53,7,17,14,167,221,444,205,94,665
Kittitas38,30,26,2,7,9,146,102,344,164,56,446
Kittitas39,37,26,4,8,12,129,123,266,153,63,389
Kittitas4,23,42,3,5,4,100,102,203,112,65,305
Kittitas40,66,49,4,11,11,160,241,438,186,115,679
Kittitas41,36,43,6,3,3,41,134,99,53,79,233
Kittitas42,23,50,1,2,3,34,125,76,40,73,201
Kittitas43,34,28,6,16,10,168,135,395,200,62,530
Kittitas44,65,53,1,18,19,172,253,356,210,118,609
Kittitas45,9,3,0,1,8,15,27,37,24,12,64
Kittitas46,20,17,0,2,3,63,66,124,68,37,190
Kittitas47,23,14,3,6,4,82,69,179,95,37,248
Kittitas48,47,58,3,12,17,120,254,328,152,105,582
Kittitas5,35,48,8,14,10,185,155,469,217,83,624
Kittitas50,24,23,2,11,12,101,80,201,126,47,281
Kittitas51,41,43,6,7,9,133,141,263,155,84,404
Kittitas52,38,46,5,13,6,121,132,283,145,84,415
Kittitas53,3,13,0,0,0,0,26,27,0,16,53
Kittitas54,27,14,2,5,3,72,83,174,82,41,257
Kittitas55,36,31,7,7,3,128,134,310,145,67,444
Kittitas56,28,29,8,16,14,94,131,276,132,57,407
Kittitas58,54,33,5,4,10,112,146,289,131,87,435
Kittitas59,21,13,0,1,4,49,56,105,54,34,161
Kittitas6,40,26,7,14,7,120,145,310,148,66,455
Kittitas60,15,21,2,2,4,90,69,172,98,36,241
Kittitas61,49,70,6,20,9,86,303,314,121,119,617
Kittitas62,27,19,2,3,2,65,89,138,72,46,227
Kittitas7,38,31,9,13,11,170,151,332,203,69,483
Kittitas8,10,15,1,2,1,8,67,21,12,25,88
Kittitas9,24,24,1,4,2,9,121,28,16,48,149
Klickitat1,10,12,2,12,5,59,38,136,78,22,174
Klickitat101,28,53,1,8,1,33,133,85,43,81,218
Klickitat102,55,34,9,32,17,162,134,333,220,89,467
Klickitat103,47,47,2,16,7,125,140,296,150,94,436
Klickitat104,43,48,12,24,5,106,114,262,147,91,376
Klickitat109,122,132,5,12,18,112,445,201,147,254,646
Klickitat11,58,67,8,14,13,173,140,380,208,125,520
Klickitat110,79,110,6,8,15,67,348,144,96,189,492
Klickitat12,83,107,13,5,17,117,281,234,152,190,515
Klickitat13,97,123,18,30,21,290,283,603,359,220,886
Klickitat14,6,7,2,6,2,33,18,54,43,13,72
Klickitat16,74,107,4,12,10,79,253,179,105,181,432
Klickitat17,19,11,0,0,0,0,40,59,0,30,99
Klickitat19,17,17,2,0,0,40,50,82,42,34,132
Klickitat2,20,27,5,17,9,152,54,306,183,47,360
Klickitat20,79,98,15,52,20,323,248,634,410,177,882
Klickitat21,18,24,7,12,5,124,70,232,148,42,302
Klickitat22,0,0,5,7,1,48,39,114,61,0,153
Klickitat23,0,0,0,3,3,9,16,31,15,0,47
Klickitat24,30,32,5,5,7,49,109,103,66,62,212
Klickitat27,3,5,2,0,0,7,7,14,9,8,21
Klickitat28,16,11,1,3,3,24,38,39,31,27,77
Klickitat3,2,4,0,0,0,0,12,48,0,6,60
Klickitat4,20,19,2,5,3,45,41,85,55,39,126
Klickitat5,75,84,2,5,17,75,282,160,99,159,442
Klickitat6,35,42,1,22,11,112,111,229,146,77,340
Klickitat7,70,108,9,10,20,108,262,274,147,178,536
Klickitat8,66,102,9,17,10,136,252,270,172,168,522
Klickitat9,45,108,2,9,5,98,236,202,114,153,438
Lewis1,54,41,15,28,14,261,197,677,318,95,874
Lewis10,89,75,23,28,22,316,288,812,389,164,1100
Lewis101,28,43,5,7,2,42,106,135,56,71,241
Lewis102,70,101,5,22,3,118,270,343,148,171,613
Lewis103,15,39,5,6,2,54,91,130,67,54,221
Lewis104,32,53,3,11,5,62,154,178,81,85,332
Lewis105,14,36,1,2,4,54,81,150,61,50,231
Lewis106,63,83,2,15,4,103,229,272,124,146,501
Lewis107,26,26,5,6,7,48,89,133,66,52,222
Lewis108,33,53,4,10,6,84,117,217,104,86,334
Lewis109,44,69,3,16,8,164,184,368,191,113,552
Lewis11,11,22,3,7,2,55,49,138,67,33,187
Lewis110,34,33,4,10,2,53,95,98,69,67,193
Lewis111,56,71,6,15,8,143,220,367,172,127,587
Lewis112,99,39,10,23,36,179,223,381,248,138,604
Lewis113,77,91,8,17,20,163,286,426,208,168,712
Lewis12,14,31,0,12,4,64,64,168,80,45,232
Lewis13,9,14,0,2,1,47,36,136,50,23,172
Lewis14,14,11,4,2,1,80,38,161,87,25,199
Lewis15,20,24,2,14,7,96,0,0,119,44,0
Lewis16,0,0,0,0,0,0,0,0,0,0,0
Lewis17,45,45,11,21,16,221,163,480,269,90,643
Lewis18,15,13,1,12,3,65,41,131,81,28,172
Lewis19,21,22,3,7,4,93,62,197,107,43,259
Lewis2,22,29,2,15,5,77,76,191,99,51,267
Lewis201,47,52,5,5,9,80,160,207,99,99,367
Lewis202,23,47,7,8,8,65,125,140,88,70,265
Lewis203,31,55,2,11,7,70,125,155,90,86,280
Lewis204,25,33,7,14,3,64,122,180,88,58,302
Lewis205,28,33,2,5,14,50,97,168,71,61,265
Lewis206,52,65,14,11,13,110,182,307,148,117,489
Lewis207,9,4,2,2,2,29,37,75,35,13,112
Lewis208,35,49,5,13,9,86,149,213,113,84,362
Lewis209,6,4,0,0,0,0,14,13,0,10,27
Lewis21,34,46,10,19,7,177,131,396,213,80,527
Lewis22,34,37,2,7,8,187,101,397,204,71,498
Lewis23,0,0,2,1,0,6,8,15,9,0,23
Lewis24,45,44,4,20,11,159,144,345,194,89,489
Lewis25,13,11,2,2,0,29,33,73,33,24,106
Lewis26,44,49,6,14,12,209,124,473,241,93,597
Lewis29,20,20,5,16,2,114,54,211,137,40,265
Lewis3,50,64,8,24,9,200,169,484,241,114,653
Lewis30,35,28,5,21,5,110,111,299,141,63,410
Lewis300,36,52,7,15,11,145,114,288,178,88,402
Lewis31,37,37,6,15,8,149,155,355,178,74,510
Lewis32,14,12,0,3,3,28,33,74,34,26,107
Lewis33,0,0,0,0,0,0,0,0,0,0,0
Lewis34,7,7,0,5,2,36,21,60,43,14,81
Lewis35,19,27,3,4,5,96,85,194,108,46,279
Lewis36,23,39,10,13,12,116,119,316,151,62,435
Lewis37,66,92,13,32,15,278,250,679,338,158,929
Lewis38,19,20,2,8,1,51,63,93,62,39,156
Lewis39,7,18,0,0,0,0,43,44,0,25,87
Lewis4,48,64,8,23,25,191,183,471,247,112,654
Lewis40,34,32,8,11,14,130,108,300,163,66,408
Lewis400,21,26,2,3,4,56,61,116,65,47,177
Lewis41,69,123,16,31,21,277,267,712,345,192,979
Lewis42,46,55,6,18,11,110,146,258,145,101,404
Lewis43,26,45,5,9,4,120,94,229,138,71,323
Lewis44,0,0,0,0,0,0,6,7,0,0,13
Lewis45,34,27,7,14,7,128,87,280,156,61,367
Lewis46,66,93,13,26,9,221,237,553,269,159,790
Lewis47,15,23,4,1,9,82,67,189,96,38,256
Lewis48,19,30,8,11,6,106,74,233,131,49,307
Lewis49,20,19,8,12,1,65,70,196,86,39,266
Lewis5,61,66,1,11,13,167,185,312,192,127,497
Lewis50,40,32,3,13,10,181,127,359,207,72,486
Lewis501,55,42,2,32,13,186,176,496,233,97,672
Lewis502,0,0,0,0,0,0,0,0,0,0,0
Lewis51,36,35,5,17,6,151,146,366,179,71,512
Lewis52,9,8,1,7,3,30,28,53,41,17,81
Lewis53,10,12,2,7,3,60,42,143,72,22,185
Lewis54,17,14,2,5,3,42,44,109,52,31,153
Lewis55,35,31,3,3,3,69,92,165,78,66,257
Lewis56,39,63,9,7,3,136,114,304,155,102,418
Lewis57,27,26,9,6,7,101,79,230,123,53,309
Lewis58,13,24,5,2,5,74,71,180,86,37,251
Lewis59,36,38,5,13,5,158,113,343,181,74,456
Lewis6,8,12,0,10,2,60,40,141,72,20,181
Lewis60,47,46,5,18,7,126,110,298,156,93,408
Lewis600,27,31,3,0,2,96,65,214,101,58,279
Lewis61,30,27,3,5,8,93,93,222,109,57,315
Lewis7,26,43,3,19,7,146,82,303,175,69,385
Lewis700,25,25,1,4,4,61,94,158,70,50,252
Lewis8,33,37,9,17,12,122,115,334,160,70,449
Lewis800,20,38,5,9,1,47,89,125,62,58,214
Lewis9,71,62,8,41,7,232,206,529,288,133,735
Lewis900,37,50,2,13,2,106,147,262,123,87,409
Lincoln1,0,0,0,2,0,11,8,44,13,0,52
Lincoln10,7,6,5,5,6,57,39,113,73,13,152
Lincoln11,0,0,0,2,0,6,3,22,8,0,25
Lincoln12,0,0,0,0,0,0,7,18,0,0,25
Lincoln13,0,0,0,0,0,0,10,31,0,0,41
Lincoln14,3,2,0,3,1,14,4,43,18,5,47
Lincoln15,0,0,1,5,6,20,5,62,32,0,67
Lincoln16,10,11,0,4,0,37,29,79,41,21,108
Lincoln17,0,0,2,2,2,15,4,27,21,0,31
Lincoln18,7,10,0,8,0,27,21,61,35,17,82
Lincoln19,21,12,1,12,4,55,48,107,72,33,155
Lincoln2,0,0,0,0,0,0,2,20,0,0,22
Lincoln20,0,0,0,0,0,0,12,26,0,0,38
Lincoln21,6,14,2,14,7,30,24,92,53,20,116
Lincoln22,6,9,2,0,0,12,15,32,14,15,47
Lincoln23,0,0,0,0,0,0,3,25,0,0,28
Lincoln24,0,0,1,5,0,37,9,73,43,0,82
Lincoln25,0,0,2,2,3,20,6,56,27,0,62
Lincoln26,5,10,5,6,4,24,28,63,39,15,91
Lincoln27,2,4,2,2,4,41,11,108,49,6,119
Lincoln28,21,13,3,0,1,67,45,108,71,34,153
Lincoln29,0,0,0,2,0,23,8,39,25,0,47
Lincoln3,0,0,0,5,1,15,6,36,21,0,42
Lincoln30,0,0,2,0,0,13,9,50,15,0,59
Lincoln31,24,28,2,4,3,83,67,128,92,52,195
Lincoln32,14,5,1,2,3,32,28,57,38,19,85
Lincoln33,11,2,1,2,5,35,17,61,43,13,78
Lincoln34,6,6,0,2,7,37,25,102,46,12,127
Lincoln35,15,10,1,6,3,37,28,90,47,25,118
Lincoln36,7,6,0,4,3,40,15,90,47,13,105
Lincoln37,0,0,0,6,0,18,9,46,24,0,55
Lincoln38,0,0,3,0,1,9,5,19,13,0,24
Lincoln39,10,10,1,10,5,38,31,90,54,20,121
Lincoln4,4,2,2,6,2,26,11,51,36,6,62
Lincoln40,15,8,1,0,3,33,32,72,37,23,104
Lincoln41,58,44,25,47,28,222,193,581,322,102,774
Lincoln42,16,9,7,12,2,59,46,132,80,25,178
Lincoln43,27,32,16,14,12,151,96,299,193,59,395
Lincoln44,19,18,3,12,4,84,56,210,103,37,266
Lincoln45,19,25,5,9,1,44,54,125,59,44,179
Lincoln46,45,28,10,15,12,144,122,316,181,73,438
Lincoln5,0,0,2,3,1,28,16,89,34,0,105
Lincoln6,3,6,1,9,2,35,15,84,47,9,99
Lincoln7,0,0,0,0,0,0,2,28,0,0,30
Lincoln8,0,0,0,0,0,0,6,34,0,0,40
Lincoln9,5,5,7,10,2,29,14,69,48,10,83
Mason113,87,91,3,21,17,179,277,371,220,178,648
Mason114,172,159,11,35,24,163,500,414,233,331,914
Mason115,155,143,13,29,20,212,436,427,274,298,863
Mason116,103,62,6,14,15,132,274,311,167,165,585
Mason117,81,58,8,18,12,125,218,265,163,139,483
Mason118,215,142,14,14,41,323,548,651,392,357,1199
Mason119,82,64,5,16,10,126,239,319,157,146,558
Mason120,69,77,8,23,10,173,259,384,214,146,643
Mason121,33,47,4,12,10,103,140,246,129,80,386
Mason122,134,134,9,22,14,203,379,448,248,268,827
Mason123,97,91,5,10,16,171,299,365,202,188,664
Mason124,68,101,13,22,14,162,302,478,211,169,780
Mason125,108,94,9,34,14,186,303,529,243,202,832
Mason126,90,68,3,13,14,119,236,240,149,158,476
Mason205,17,11,3,5,0,19,45,63,27,28,108
Mason207,79,93,3,2,7,52,279,143,64,172,422
Mason227,192,134,8,32,29,237,533,538,306,326,1071
Mason228,35,17,2,1,1,17,144,32,21,52,176
Mason229,136,112,8,24,29,207,408,387,268,248,795
Mason230,181,106,2,15,13,187,386,399,217,287,785
Mason231,23,40,6,11,4,56,106,165,77,63,271
Mason232,94,110,6,18,3,189,320,426,216,204,746
Mason233,69,94,6,24,7,141,273,359,178,163,632
Mason234,30,42,4,5,1,75,135,172,85,72,307
Mason235,44,82,1,14,5,95,200,241,115,126,441
Mason236,106,134,4,37,11,207,422,526,259,240,948
Mason237,68,74,7,15,5,130,230,340,157,142,570
Mason238,144,166,3,15,28,243,501,569,289,310,1070
Mason301,143,134,6,22,26,166,425,415,220,277,840
Mason302,86,127,7,18,1,96,324,289,122,213,613
Mason303,106,121,10,32,15,133,355,358,190,227,713
Mason304,55,91,0,5,12,91,261,268,108,146,529
Mason306,126,134,6,30,15,153,399,455,204,260,854
Mason308,122,141,6,30,19,139,454,387,194,263,841
Mason309,132,124,10,19,13,209,426,498,251,256,924
Mason310,106,119,7,14,9,167,313,407,197,225,720
Mason311,66,78,7,17,17,111,234,330,152,144,564
Mason312,112,144,8,26,11,204,400,451,249,256,851
Mason339,2,4,0,2,1,5,10,11,8,6,21
Okanogan1,4,7,0,2,0,19,14,41,21,11,55
Okanogan10,5,7,1,4,0,17,14,33,22,12,47
Okanogan100,0,0,0,7,0,6,11,23,13,0,34
Okanogan101,14,8,2,0,0,28,56,51,30,22,107
Okanogan102,11,13,1,2,3,18,55,33,24,24,88
Okanogan103,5,5,3,1,0,11,26,28,15,10,54
Okanogan104,14,13,0,0,0,0,51,5,0,27,56
Okanogan105,6,6,2,1,0,8,17,34,11,12,51
Okanogan106,6,12,2,3,1,27,21,61,33,18,82
Okanogan107,6,2,0,0,2,7,23,30,9,8,53
Okanogan108,6,6,3,3,1,9,35,41,16,12,76
Okanogan109,3,4,0,2,2,6,15,30,10,7,45
Okanogan11,2,4,0,0,0,0,8,38,0,6,46
Okanogan110,4,14,0,2,2,15,43,45,19,18,88
Okanogan111,7,14,0,0,0,0,40,11,0,21,51
Okanogan112,8,9,0,1,2,14,30,31,17,17,61
Okanogan113,10,12,1,2,0,17,32,34,20,22,66
Okanogan114,0,0,1,5,4,12,24,42,22,0,66
Okanogan115,6,8,1,2,0,15,25,27,18,14,52
Okanogan116,12,9,0,0,0,0,45,13,0,21,58
Okanogan117,17,10,1,4,4,22,50,57,31,27,107
Okanogan118,9,9,0,2,0,22,22,44,24,18,66
Okanogan119,5,5,0,3,2,11,20,24,16,10,44
Okanogan12,4,5,0,0,0,0,17,30,0,9,47
Okanogan120,4,4,0,0,0,0,16,34,0,8,50
Okanogan121,6,8,2,0,0,10,20,38,12,14,58
Okanogan122,3,22,0,2,2,14,28,26,18,25,54
Okanogan123,2,6,0,0,0,0,13,21,0,8,34
Okanogan124,0,0,3,2,0,15,13,41,20,0,54
Okanogan125,9,7,3,8,2,34,23,64,47,16,87
Okanogan126,6,4,0,0,0,0,20,50,0,10,70
Okanogan127,2,4,2,1,0,25,14,43,28,6,57
Okanogan128,16,26,1,3,2,15,75,35,21,42,110
Okanogan129,15,28,0,0,0,0,69,53,0,43,122
Okanogan13,0,0,0,0,0,0,11,29,0,0,40
Okanogan130,32,22,1,5,3,17,100,43,26,54,143
Okanogan131,9,11,4,4,0,37,30,68,45,20,98
Okanogan132,9,11,0,0,0,0,40,22,0,20,62
Okanogan133,18,18,0,0,0,0,57,40,0,36,97
Okanogan134,6,11,5,2,0,35,33,77,42,17,110
Okanogan135,12,20,1,1,3,27,62,63,32,32,125
Okanogan136,8,10,0,0,0,0,28,21,0,18,49
Okanogan137,18,29,0,2,6,10,76,35,18,47,111
Okanogan138,0,0,1,1,3,16,12,39,21,0,51
Okanogan139,0,0,1,2,2,22,5,41,27,0,46
Okanogan14,12,8,3,1,1,48,33,88,53,20,121
Okanogan140,0,0,0,3,1,21,10,44,25,0,54
Okanogan141,0,0,0,1,3,23,15,50,27,0,65
Okanogan142,0,0,1,1,3,14,14,35,19,0,49
Okanogan143,8,7,1,2,2,25,20,61,30,15,81
Okanogan144,2,3,0,0,0,0,7,35,0,5,42
Okanogan145,5,3,0,0,0,0,13,28,0,8,41
Okanogan146,0,0,1,3,0,18,8,45,22,0,53
Okanogan147,7,4,0,0,0,0,25,32,0,11,57
Okanogan148,4,3,1,3,0,21,17,42,25,7,59
Okanogan149,0,0,0,3,0,10,4,22,13,0,26
Okanogan15,8,7,0,7,0,30,29,58,37,15,87
Okanogan150,5,8,0,4,1,20,23,51,25,13,74
Okanogan151,0,0,0,2,0,32,13,62,34,0,75
Okanogan152,5,5,1,2,1,29,19,76,33,10,95
Okanogan153,0,0,0,2,1,11,15,40,14,0,55
Okanogan154,5,12,0,2,0,12,19,25,14,17,44
Okanogan155,0,0,0,0,0,0,17,51,0,0,68
Okanogan156,4,9,1,2,1,18,30,34,22,13,64
Okanogan157,0,0,0,0,0,0,11,34,0,0,45
Okanogan158,3,7,1,3,0,7,13,30,11,10,43
Okanogan159,0,0,0,0,0,0,2,26,0,0,28
Okanogan16,13,23,1,5,3,24,57,54,33,36,111
Okanogan160,7,3,4,3,0,20,18,45,27,10,63
Okanogan161,0,0,0,0,0,0,16,34,0,0,50
Okanogan162,6,12,1,7,0,24,33,81,32,18,114
Okanogan163,4,15,1,4,2,22,27,36,29,19,63
Okanogan164,9,10,2,2,0,10,25,31,14,19,56
Okanogan165,5,21,0,0,0,0,29,42,0,26,71
Okanogan166,0,0,3,3,5,26,5,46,37,0,51
Okanogan167,4,7,0,1,2,11,15,26,14,11,41
Okanogan168,2,3,0,2,0,4,10,22,6,5,32
Okanogan169,3,4,0,0,3,17,16,34,20,7,50
Okanogan17,5,2,0,3,1,14,16,31,18,7,47
Okanogan170,6,14,0,0,0,0,25,28,0,20,53
Okanogan171,6,7,0,0,0,0,23,34,0,13,57
Okanogan172,2,4,0,3,0,11,8,26,14,6,34
Okanogan173,2,13,0,4,1,27,24,57,32,15,81
Okanogan174,10,23,4,2,3,30,34,58,39,33,92
Okanogan175,12,12,0,2,3,16,36,42,21,24,78
Okanogan176,0,0,1,3,1,21,13,34,26,0,47
Okanogan177,5,8,0,3,0,18,20,38,21,13,58
Okanogan178,0,0,2,0,3,29,18,52,34,0,70
Okanogan179,5,6,0,0,0,0,14,52,0,11,66
Okanogan18,4,18,2,3,4,37,31,67,46,22,98
Okanogan180,13,8,0,3,1,11,56,27,15,21,83
Okanogan181,5,6,0,0,0,0,34,24,0,11,58
Okanogan182,10,8,1,1,2,9,44,23,13,18,67
Okanogan183,5,3,0,2,0,9,23,19,11,8,42
Okanogan184,0,0,5,1,0,29,24,54,35,0,78
Okanogan185,6,5,0,0,0,0,17,48,0,11,65
Okanogan186,7,5,0,4,4,14,24,32,22,12,56
Okanogan187,5,7,0,0,0,0,15,26,0,12,41
Okanogan188,3,7,0,1,3,24,17,59,28,10,76
Okanogan189,9,10,3,5,0,33,28,66,41,19,94
Okanogan19,3,10,1,2,4,34,21,59,41,13,80
Okanogan190,0,0,0,0,0,0,11,34,0,0,45
Okanogan191,6,22,0,0,0,0,55,11,0,28,66
Okanogan192,8,3,0,0,0,0,14,23,0,11,37
Okanogan193,11,7,0,0,0,0,30,27,0,18,57
Okanogan194,4,8,1,1,4,20,24,47,26,12,71
Okanogan195,0,0,1,2,2,31,24,46,36,0,70
Okanogan196,12,10,1,3,3,24,38,39,31,22,77
Okanogan197,4,10,2,5,2,25,16,65,34,14,81
Okanogan198,3,5,1,5,1,23,10,60,30,8,70
Okanogan199,5,2,0,0,6,32,16,64,38,7,80
Okanogan2,8,7,2,0,0,36,24,71,38,15,95
Okanogan20,7,12,0,0,0,0,42,82,0,19,124
Okanogan200,3,9,2,2,2,20,16,61,26,12,77
Okanogan201,5,8,0,0,0,0,19,57,0,13,76
Okanogan202,8,13,0,0,0,0,26,45,0,21,71
Okanogan203,9,9,2,6,3,41,24,72,52,18,96
Okanogan204,5,9,0,2,1,24,26,41,27,14,67
Okanogan205,0,0,0,0,0,0,20,37,0,0,57
Okanogan206,4,5,0,0,0,0,19,17,0,9,36
Okanogan207,9,4,2,7,2,25,17,63,36,13,80
Okanogan208,7,8,1,5,2,18,32,37,26,15,69
Okanogan209,11,19,1,0,3,33,39,58,37,30,97
Okanogan21,30,43,0,0,0,0,141,33,0,73,174
Okanogan210,8,9,0,0,0,0,27,19,0,17,46
Okanogan211,5,8,1,2,2,14,16,44,19,13,60
Okanogan212,7,4,2,0,0,22,15,44,24,11,59
Okanogan213,5,4,0,0,2,15,14,29,17,9,43
Okanogan214,2,11,1,1,5,21,26,38,28,13,64
Okanogan215,5,9,0,0,0,0,15,21,0,14,36
Okanogan216,7,11,0,0,0,0,31,16,0,18,47
Okanogan217,10,10,1,3,1,24,34,38,29,20,72
Okanogan218,6,6,0,4,0,20,21,38,24,12,59
Okanogan219,5,8,0,0,0,0,20,16,0,13,36
Okanogan22,15,15,3,0,3,38,43,66,44,30,109
Okanogan220,3,7,2,1,1,14,21,34,18,10,55
Okanogan221,8,6,1,2,3,13,25,40,19,14,65
Okanogan222,9,6,0,1,5,25,18,58,31,15,76
Okanogan223,4,9,0,0,0,0,14,56,0,13,70
Okanogan224,5,11,0,2,1,10,17,40,13,16,57
Okanogan225,7,5,2,0,0,7,18,27,9,12,45
Okanogan226,7,8,0,0,0,0,22,37,0,15,59
Okanogan23,7,7,1,2,0,7,22,28,10,14,50
Okanogan236,2,3,0,1,2,4,4,21,7,5,25
Okanogan237,0,0,5,0,1,16,6,41,22,0,47
Okanogan24,12,17,2,0,3,23,29,66,28,29,95
Okanogan25,5,2,2,4,5,23,13,72,34,7,85
Okanogan27,6,10,0,0,0,0,29,10,0,16,39
Okanogan28,3,4,0,0,0,0,10,20,0,7,30
Okanogan29,7,6,0,4,1,5,17,28,10,13,45
Okanogan3,7,6,2,3,2,41,17,84,48,13,101
Okanogan30,8,8,0,1,2,26,0,0,29,16,0
Okanogan31,0,0,0,0,0,0,0,0,0,0,0
Okanogan32,5,5,3,1,2,37,25,86,43,10,111
Okanogan33,4,12,1,6,3,46,22,94,56,16,116
Okanogan34,16,17,1,1,3,37,40,67,42,33,107
Okanogan35,4,4,4,2,1,33,9,67,40,8,76
Okanogan36,3,8,0,5,5,27,25,63,37,11,88
Okanogan37,5,12,7,3,0,10,19,34,20,17,53
Okanogan38,12,19,1,3,1,39,49,74,44,31,123
Okanogan39,10,26,0,3,0,14,60,34,17,36,94
Okanogan4,7,4,0,0,0,0,14,28,0,11,42
Okanogan40,9,15,0,0,0,0,58,28,0,24,86
Okanogan41,7,10,0,10,3,32,22,53,45,17,75
Okanogan42,5,3,0,0,0,0,7,33,0,8,40
Okanogan43,3,5,0,4,4,18,13,36,26,8,49
Okanogan44,23,21,0,0,8,27,79,46,35,44,125
Okanogan45,0,0,3,4,2,24,17,61,33,0,78
Okanogan46,5,3,0,2,2,21,16,48,25,8,64
Okanogan47,3,7,0,0,0,0,19,52,0,10,71
Okanogan48,4,8,1,12,0,22,16,59,35,12,75
Okanogan49,17,11,0,0,0,0,43,7,0,28,50
Okanogan5,6,5,0,0,0,0,13,39,0,11,52
Okanogan50,2,8,2,7,5,43,19,91,57,10,110
Okanogan51,3,9,0,0,0,0,28,13,0,12,41
Okanogan52,0,0,1,2,0,9,12,28,12,0,40
Okanogan53,0,0,3,0,1,21,5,47,25,0,52
Okanogan54,2,11,0,0,0,0,18,28,0,13,46
Okanogan55,2,6,2,2,0,44,20,55,48,8,75
Okanogan56,14,20,1,0,2,14,55,43,17,34,98
Okanogan57,14,12,2,1,1,28,34,57,32,26,91
Okanogan58,13,16,0,0,0,0,44,3,0,29,47
Okanogan59,9,5,0,4,0,23,27,51,27,14,78
Okanogan6,5,13,4,1,1,35,31,69,41,18,100
Okanogan60,26,36,1,3,4,7,112,23,15,62,135
Okanogan61,9,9,1,4,5,18,29,58,28,18,87
Okanogan62,12,17,2,0,2,20,43,60,24,29,103
Okanogan63,6,5,0,0,0,0,18,32,0,11,50
Okanogan64,3,6,0,0,0,0,4,30,0,9,34
Okanogan65,14,36,3,3,3,35,62,79,44,50,141
Okanogan66,7,3,0,0,0,0,10,10,0,10,20
Okanogan67,3,6,0,0,0,0,13,18,0,9,31
Okanogan68,10,23,0,0,2,6,43,10,8,33,53
Okanogan69,11,7,0,0,0,0,25,32,0,18,57
Okanogan7,5,8,0,1,2,27,26,57,30,13,83
Okanogan70,9,6,0,0,0,0,21,37,0,15,58
Okanogan71,6,21,0,3,3,39,48,69,45,27,117
Okanogan72,9,11,2,5,1,32,19,70,40,20,89
Okanogan74,7,13,2,5,2,57,23,84,66,20,107
Okanogan75,18,21,3,4,3,41,65,77,51,39,142
Okanogan76,0,0,0,2,0,14,17,43,16,0,60
Okanogan77,4,15,2,3,0,35,29,74,40,19,103
Okanogan78,21,14,1,3,3,23,73,31,30,35,104
Okanogan79,0,0,0,0,0,0,10,46,0,0,56
Okanogan8,6,16,0,2,1,14,33,29,17,22,62
Okanogan81,13,18,0,5,2,20,49,40,27,31,89
Okanogan82,14,19,0,3,0,15,43,30,18,33,73
Okanogan83,15,23,0,0,0,0,58,15,0,38,73
Okanogan84,5,13,0,2,2,22,35,44,26,18,79
Okanogan85,29,15,0,0,0,0,78,32,0,44,110
Okanogan86,3,6,0,0,0,0,13,46,0,9,59
Okanogan87,7,3,0,0,0,0,14,47,0,10,61
Okanogan88,37,25,0,2,2,14,116,34,18,62,150
Okanogan89,0,0,0,0,0,0,6,35,0,0,41
Okanogan9,0,0,0,6,0,23,14,44,29,0,58
Okanogan90,21,28,3,0,2,28,75,63,33,49,138
Okanogan91,16,29,3,6,3,15,76,40,27,45,116
Okanogan92,8,10,1,6,2,32,23,84,41,18,107
Okanogan93,43,26,0,2,1,14,110,36,17,69,146
Okanogan94,19,13,0,0,0,0,54,27,0,32,81
Okanogan95,5,6,4,1,0,32,17,62,37,11,79
Okanogan96,4,9,1,2,3,25,16,45,31,13,61
Okanogan97,4,9,0,2,2,13,20,50,17,13,70
Okanogan98,3,6,1,2,0,13,16,48,16,9,64
Okanogan99,5,7,1,2,0,26,13,39,29,12,52
Pacific1,15,9,0,1,2,27,36,70,30,24,106
Pacific101,57,67,3,9,8,103,237,224,123,124,461
Pacific103,121,117,6,10,11,181,338,349,208,238,687
Pacific105,0,0,0,3,0,13,15,24,16,0,39
Pacific106,24,30,0,1,5,46,83,109,52,54,192
Pacific107,31,21,2,4,0,42,84,96,48,52,180
Pacific108,30,30,3,9,3,58,88,115,73,60,203
Pacific11,47,53,4,16,5,98,149,293,123,100,442
Pacific110,45,65,4,14,2,67,148,180,87,110,328
Pacific113,41,45,0,3,0,39,133,109,42,86,242
Pacific115,20,23,0,2,5,24,77,63,31,43,140
Pacific117,31,25,2,4,3,37,85,111,46,56,196
Pacific12,190,151,6,15,22,241,468,502,284,341,970
Pacific13,67,95,14,19,13,152,227,380,198,162,607
Pacific15,10,16,2,1,0,14,15,38,17,26,53
Pacific16,64,79,0,4,7,109,195,205,120,143,400
Pacific17,33,38,1,6,0,79,94,133,86,71,227
Pacific18,5,9,0,2,0,12,18,22,14,14,40
Pacific19,50,36,5,3,7,74,151,129,89,86,280
Pacific2,29,37,2,5,2,59,82,114,68,66,196
Pacific20,162,98,9,14,20,150,379,319,193,260,698
Pacific21,117,96,5,22,9,111,297,214,147,213,511
Pacific22,64,43,6,6,9,74,164,141,95,107,305
Pacific23,4,9,0,5,1,14,28,38,20,13,66
Pacific24,12,7,0,0,0,0,27,32,0,19,59
Pacific25,83,67,6,11,7,84,228,199,108,150,427
Pacific26,0,0,0,0,0,0,4,26,0,0,30
Pacific27,8,13,2,0,0,22,47,54,24,21,101
Pacific28,2,7,2,2,1,16,15,40,21,9,55
Pacific29,0,0,0,0,0,0,0,0,0,0,0
Pacific3,40,47,3,7,8,81,123,171,99,87,294
Pacific30,0,0,0,0,0,0,0,0,0,0,0
Pacific32,24,23,0,5,0,22,75,76,27,47,151
Pacific34,48,52,1,12,12,98,183,290,123,100,473
Pacific4,11,12,0,2,4,9,42,43,15,23,85
Pacific6,20,27,3,7,2,69,47,165,81,47,212
Pacific7,0,0,0,0,0,0,2,10,0,0,12
Pacific8,7,11,1,2,6,21,29,34,30,18,63
Pacific9,84,76,5,5,12,120,202,225,142,160,427
Pend Oreille1,16,16,12,15,6,56,49,196,89,32,245
Pend Oreille10,33,33,8,14,7,55,82,135,84,66,217
Pend Oreille11,44,36,6,13,2,145,109,264,166,80,373
Pend Oreille12,38,36,0,6,8,114,102,230,128,74,332
Pend Oreille13,17,29,1,4,3,56,47,89,64,46,136
Pend Oreille14,49,34,2,18,6,66,110,183,92,83,293
Pend Oreille15,31,32,4,7,11,58,77,167,80,63,244
Pend Oreille16,45,62,5,16,6,136,128,280,163,107,408
Pend Oreille17,5,5,0,1,2,16,11,23,19,10,34
Pend Oreille18,63,49,2,11,6,66,159,174,85,112,333
Pend Oreille19,18,27,3,9,3,90,51,177,105,45,228
Pend Oreille2,14,28,0,3,4,49,56,132,56,42,188
Pend Oreille20,22,35,9,10,6,90,74,199,115,57,273
Pend Oreille21,23,43,4,12,5,79,85,198,100,66,283
Pend Oreille22,7,4,1,6,0,21,17,48,28,11,65
Pend Oreille23,16,27,1,1,5,61,73,107,68,43,180
Pend Oreille24,6,13,0,0,0,0,20,55,0,19,75
Pend Oreille25,2,16,0,0,0,0,24,60,0,18,84
Pend Oreille26,13,15,4,11,7,85,46,165,107,28,211
Pend Oreille27,80,60,8,24,12,134,205,293,178,140,498
Pend Oreille3,36,53,12,8,4,110,121,242,134,89,363
Pend Oreille4,11,26,3,10,1,53,35,124,67,37,159
Pend Oreille5,10,18,2,8,2,87,45,190,99,28,235
Pend Oreille6,30,24,4,16,5,92,89,226,117,54,315
Pend Oreille7,18,19,6,4,2,81,41,151,93,37,192
Pend Oreille8,10,26,5,6,1,110,41,183,122,36,224
Pend Oreille9,15,14,5,2,2,35,37,82,44,29,119
Pierce2101,30,27,2,7,3,63,89,150,75,57,239
Pierce2105,23,24,1,8,5,66,91,185,80,47,276
Pierce2106,85,78,12,19,16,185,286,505,232,163,791
Pierce2110,37,37,1,10,9,105,193,334,125,74,527
Pierce2111,45,60,4,25,8,140,304,424,177,105,728
Pierce2112,50,50,5,7,4,87,209,290,103,100,499
Pierce2113,64,55,11,7,13,130,214,278,161,119,492
Pierce2114,51,43,7,13,12,104,190,324,136,94,514
Pierce2115,57,52,6,15,11,144,305,389,176,109,694
Pierce2116,85,87,3,43,10,145,440,555,201,172,995
Pierce2117,87,111,7,23,8,186,452,562,224,198,1014
Pierce2118,54,44,6,19,6,94,281,272,125,98,553
Pierce2119,57,51,2,17,2,70,195,242,91,108,437
Pierce2120,73,78,6,19,7,101,327,398,133,151,725
Pierce2121,36,43,0,17,8,87,202,295,112,79,497
Pierce2122,78,81,3,17,8,126,342,421,154,159,763
Pierce2123,74,65,11,18,11,181,296,535,221,139,831
Pierce2124,57,77,11,27,17,125,355,406,180,134,761
Pierce2125,52,72,7,15,5,115,316,389,142,124,705
Pierce2126,80,73,6,21,13,138,440,542,178,153,982
Pierce2127,63,37,3,12,8,81,227,230,104,100,457
Pierce2128,97,55,4,24,15,114,395,424,157,152,819
Pierce2129,66,70,8,19,6,74,309,280,107,136,589
Pierce2130,64,52,5,14,14,55,312,245,88,116,557
Pierce2131,107,90,4,32,18,204,415,570,258,197,985
Pierce2133,26,22,1,6,5,49,128,123,61,48,251
Pierce2134,84,65,6,21,4,140,393,451,171,149,844
Pierce2135,64,56,3,25,15,224,257,569,267,120,826
Pierce2136,16,19,0,4,1,51,59,103,56,35,162
Pierce2137,40,31,4,17,8,121,142,348,150,71,490
Pierce2138,38,20,13,8,2,96,123,253,119,58,376
Pierce2139,48,72,5,35,7,183,198,457,230,120,655
Pierce2140,58,87,9,16,11,219,261,589,255,145,850
Pierce2141,77,74,9,22,15,185,249,565,231,151,814
Pierce2142,56,38,7,11,14,151,193,389,183,94,582
Pierce2143,70,46,12,15,10,164,206,411,201,116,617
Pierce2144,67,72,9,25,8,215,304,573,257,139,877
Pierce2145,56,78,8,26,14,192,211,547,240,134,758
Pierce2146,66,52,8,28,5,155,210,428,196,118,638
Pierce2147,56,47,4,17,6,165,208,401,192,103,609
Pierce2148,84,65,3,26,20,204,270,505,253,149,775
Pierce2149,84,66,3,16,13,222,299,553,254,150,852
Pierce2150,42,57,14,17,15,121,217,437,167,99,654
Pierce2151,22,20,5,7,9,62,89,155,83,42,244
Pierce2152,60,65,10,33,15,227,206,599,285,125,805
Pierce2153,68,47,10,18,8,173,213,503,209,115,716
Pierce2154,35,29,10,21,10,156,200,460,197,64,660
Pierce2155,57,76,15,15,13,202,254,553,245,133,807
Pierce2156,87,83,10,36,21,248,320,655,315,170,975
Pierce2157,90,87,13,34,12,228,308,644,287,177,952
Pierce2158,73,81,4,14,13,139,230,339,170,154,569
Pierce2159,36,45,7,14,3,114,152,319,138,81,471
Pierce2160,29,44,5,12,6,66,272,220,89,73,492
Pierce2161,15,14,2,1,7,42,72,144,52,29,216
Pierce2162,65,50,12,19,10,150,249,475,191,115,724
Pierce25201,122,71,7,16,21,142,504,441,186,193,945
Pierce25202,91,136,5,13,14,121,485,371,153,227,856
Pierce25203,124,88,6,12,10,151,463,436,179,212,899
Pierce25204,120,87,7,20,18,111,418,343,156,207,761
Pierce25205,44,53,6,5,11,45,206,152,67,97,358
Pierce25206,99,83,7,7,3,76,291,243,93,182,534
Pierce25207,63,89,2,13,5,89,378,280,109,152,658
Pierce25208,134,117,9,30,23,137,458,438,199,251,896
Pierce25209,119,76,9,24,23,155,456,446,211,195,902
Pierce25210,120,118,3,34,29,169,513,526,235,238,1039
Pierce25211,104,97,6,11,11,133,456,414,161,201,870
Pierce25212,118,100,12,14,15,156,505,453,197,218,958
Pierce25213,104,90,11,29,26,129,467,424,195,194,891
Pierce25215,168,76,9,31,13,166,452,428,219,244,880
Pierce25216,50,76,2,14,13,119,285,341,148,126,626
Pierce25217,87,97,4,17,32,165,437,459,218,184,896
Pierce25218,106,72,6,18,25,142,439,408,191,178,847
Pierce25219,95,81,7,21,34,195,432,649,257,176,1081
Pierce25220,0,0,0,0,0,0,0,0,0,0,0
Pierce25221,71,62,11,18,18,137,361,443,184,133,804
Pierce25222,119,101,13,18,13,101,418,327,145,220,745
Pierce25226,74,85,7,12,6,77,436,307,102,159,743
Pierce25227,75,58,4,14,9,74,385,246,101,133,631
Pierce25228,113,111,4,16,9,122,585,368,151,224,953
Pierce25230,38,24,0,1,2,39,154,102,42,62,256
Pierce25235,3,2,0,0,0,0,5,16,0,5,21
Pierce25236,97,68,6,9,5,111,283,309,131,165,592
Pierce25237,0,0,0,0,0,0,2,3,0,0,5
Pierce25238,58,46,3,6,3,109,216,221,121,104,437
Pierce25239,93,89,12,24,7,135,342,430,178,182,772
Pierce25240,55,47,3,5,7,93,199,179,108,102,378
Pierce25241,68,60,4,8,4,81,289,192,97,128,481
Pierce25242,105,88,3,26,18,188,374,474,235,193,848
Pierce25243,106,74,3,16,4,98,419,328,121,180,747
Pierce25244,131,84,10,11,24,186,443,471,231,215,914
Pierce25245,0,0,0,0,0,0,8,14,0,0,22
Pierce25246,18,3,0,7,1,10,42,35,18,21,77
Pierce25247,97,92,10,24,11,123,405,365,168,189,770
Pierce25248,138,90,15,17,22,192,426,507,246,228,933
Pierce25249,118,93,6,23,21,124,449,412,174,211,861
Pierce25250,35,31,2,10,14,64,153,181,90,66,334
Pierce25251,85,64,8,18,12,141,351,407,179,149,758
Pierce25252,99,101,3,16,9,113,464,348,141,200,812
Pierce25253,57,70,7,17,5,90,340,276,119,127,616
Pierce25254,75,82,2,12,6,56,431,225,76,157,656
Pierce25255,74,48,8,5,8,107,267,250,128,122,517
Pierce25256,93,69,10,21,3,132,354,363,166,162,717
Pierce25257,87,86,5,23,11,153,371,443,192,173,814
Pierce25258,114,97,9,14,6,159,377,472,188,211,849
Pierce25259,102,75,5,22,13,141,457,462,181,177,919
Pierce25260,98,112,6,24,24,175,488,545,229,210,1033
Pierce25261,76,69,2,11,8,126,347,373,147,145,720
Pierce25262,98,64,13,20,10,156,385,504,199,162,889
Pierce25263,69,55,7,23,14,124,296,406,168,124,702
Pierce25264,89,104,9,12,5,161,434,470,187,193,904
Pierce25265,123,91,11,21,8,175,421,398,215,214,819
Pierce25266,92,62,10,23,18,168,436,522,219,154,958
Pierce25267,45,44,2,13,8,92,220,228,115,89,448
Pierce25268,69,71,2,9,2,92,345,325,105,140,670
Pierce25269,66,76,11,10,11,113,337,363,145,142,700
Pierce25270,74,98,13,28,10,138,448,527,189,172,975
Pierce25271,92,90,9,22,19,120,395,412,170,182,807
Pierce25272,97,67,11,30,25,143,371,444,209,164,815
Pierce25273,46,48,7,25,10,110,282,336,152,94,618
Pierce25274,88,69,9,30,21,176,383,518,236,157,901
Pierce25275,0,0,0,0,0,0,0,0,0,0,0
Pierce25276,0,0,0,0,0,0,12,9,0,0,21
Pierce25277,82,106,7,29,9,148,420,464,193,188,884
Pierce25278,38,18,2,15,3,68,163,205,88,56,368
Pierce25279,66,50,6,25,18,111,285,350,160,116,635
Pierce25280,98,65,13,31,23,166,407,480,233,163,887
Pierce25281,67,52,9,8,11,115,259,294,143,119,553
Pierce25282,75,96,8,25,20,157,338,503,210,171,841
Pierce25283,54,51,3,7,4,70,289,300,84,105,589
Pierce25284,29,44,1,9,7,75,158,219,92,73,377
Pierce25285,116,55,7,28,24,200,443,599,259,171,1042
Pierce25286,91,80,5,20,14,115,413,427,154,171,840
Pierce25287,0,0,0,0,0,0,4,4,0,0,8
Pierce25288,87,55,9,22,22,193,408,585,246,142,993
Pierce25289,0,0,0,0,0,0,0,0,0,0,0
Pierce25290,5,14,0,4,1,22,37,59,27,19,96
Pierce25291,21,13,2,3,3,44,83,123,52,34,206
Pierce25292,109,101,9,13,19,167,391,464,208,210,855
Pierce25293,91,83,11,15,24,114,359,425,164,174,784
Pierce26301,43,14,3,6,8,60,146,150,77,57,296
Pierce26302,157,98,4,19,40,152,548,384,215,255,932
Pierce26303,181,114,10,22,37,208,556,466,277,295,1022
Pierce26304,238,108,10,29,52,209,681,493,300,346,1174
Pierce26305,165,115,11,27,47,233,630,525,318,280,1155
Pierce26306,66,42,1,9,14,71,277,219,95,108,496
Pierce26314,60,80,5,17,8,113,251,268,143,140,519
Pierce26315,87,117,10,21,8,179,393,484,218,204,877
Pierce26316,48,47,5,10,5,77,205,277,97,95,482
Pierce26317,86,121,6,21,9,151,383,420,187,207,803
Pierce26318,82,80,3,29,5,144,344,404,181,162,748
Pierce26319,84,87,5,20,22,113,375,396,160,171,771
Pierce26320,109,116,6,14,21,146,395,395,187,225,790
Pierce26321,105,156,13,22,19,194,510,582,248,261,1092
Pierce26322,102,132,16,22,15,211,386,515,264,234,901
Pierce26323,148,147,3,30,20,173,470,452,226,295,922
Pierce26324,111,89,5,20,25,162,372,423,212,200,795
Pierce26325,78,98,7,21,22,147,390,428,197,176,818
Pierce26326,128,104,9,21,11,143,449,416,184,232,865
Pierce26327,122,78,2,23,37,145,460,372,207,200,832
Pierce26328,110,61,11,22,28,152,351,422,213,171,773
Pierce26329,101,44,3,21,36,192,408,479,252,145,887
Pierce26330,62,65,8,12,17,122,272,256,159,127,528
Pierce26331,31,19,0,2,9,50,103,121,61,50,224
Pierce26332,104,77,2,13,22,115,409,333,152,181,742
Pierce26333,95,94,10,14,19,159,438,436,202,189,874
Pierce26334,98,80,4,16,37,119,417,389,176,178,806
Pierce26335,73,94,10,14,12,83,347,314,119,167,661
Pierce26336,103,99,6,34,30,173,529,499,243,202,1028
Pierce26337,111,105,16,24,28,153,451,411,221,216,862
Pierce26338,96,55,4,14,26,110,354,355,154,151,709
Pierce26339,19,8,0,5,16,16,67,52,37,27,119
Pierce26340,98,110,12,26,30,158,486,496,226,208,982
Pierce26341,110,99,9,31,21,127,429,392,188,209,821
Pierce26342,105,103,9,25,31,147,471,426,212,208,897
Pierce26343,103,63,6,12,28,120,382,323,166,166,705
Pierce26344,15,14,0,2,2,12,64,44,16,29,108
Pierce26345,101,79,3,16,27,112,367,354,158,180,721
Pierce26346,78,65,7,14,20,120,363,299,161,143,662
Pierce26347,114,81,2,19,34,138,322,337,193,195,659
Pierce26348,112,89,7,24,36,138,430,384,205,201,814
Pierce26349,114,83,10,17,30,148,470,409,205,197,879
Pierce26350,114,75,7,8,21,154,419,424,190,189,843
Pierce26351,101,82,6,26,20,112,388,367,164,183,755
Pierce26352,70,90,6,26,34,113,355,357,179,160,712
Pierce27401,77,78,3,7,20,58,336,141,88,155,477
Pierce27404,47,70,0,2,7,12,355,33,21,117,388
Pierce27405,193,125,4,10,38,100,621,254,152,318,875
Pierce27406,234,128,12,16,22,156,702,359,206,362,1061
Pierce27407,133,149,6,13,11,99,623,286,129,282,909
Pierce27408,149,101,4,16,10,105,536,313,135,250,849
Pierce27409,158,148,9,19,9,105,671,309,142,306,980
Pierce27410,141,132,5,11,16,93,621,249,125,273,870
Pierce27411,187,144,1,17,27,129,818,342,174,331,1160
Pierce27412,139,119,4,22,14,103,502,292,143,258,794
Pierce27413,163,119,3,11,19,88,589,243,121,282,832
Pierce27414,166,142,2,3,20,79,718,210,104,308,928
Pierce27415,173,116,3,13,15,130,611,301,161,289,912
Pierce27416,154,158,6,18,16,66,709,226,106,312,935
Pierce27417,139,133,7,14,11,74,756,210,106,272,966
Pierce27418,137,142,2,8,14,71,675,190,95,279,865
Pierce27419,123,161,6,8,15,78,680,222,107,284,902
Pierce27420,180,151,7,16,7,62,755,184,92,331,939
Pierce27421,89,160,3,7,9,43,629,176,62,249,805
Pierce27422,195,129,3,11,28,78,764,223,120,324,987
Pierce27423,157,175,1,6,17,66,796,186,90,332,982
Pierce27424,170,129,2,8,13,71,695,189,94,299,884
Pierce27425,118,178,1,8,9,44,718,148,62,296,866
Pierce27426,146,100,3,6,20,81,628,189,110,246,817
Pierce27427,114,194,2,5,21,74,740,179,102,308,919
Pierce27428,103,186,2,5,7,51,746,161,65,289,907
Pierce27429,178,127,2,18,8,66,736,190,94,305,926
Pierce27430,159,143,6,12,22,100,763,303,140,302,1066
Pierce27431,67,43,2,6,5,32,276,103,45,110,379
Pierce27432,133,130,6,10,9,112,589,312,137,263,901
Pierce27433,114,188,9,13,11,77,652,227,110,302,879
Pierce27434,128,147,8,15,9,76,601,238,108,275,839
Pierce27435,188,108,6,24,12,98,569,247,140,296,816
Pierce27436,118,184,3,12,9,68,728,189,92,302,917
Pierce27437,146,161,2,6,3,48,679,171,59,307,850
Pierce27438,142,173,7,14,7,38,724,162,66,315,886
Pierce27439,135,223,4,11,6,52,759,151,73,358,910
Pierce27440,171,162,0,4,13,51,777,151,68,333,928
Pierce27441,142,125,7,10,4,48,643,169,69,267,812
Pierce27442,79,128,2,9,3,61,422,212,75,207,634
Pierce27443,108,87,5,13,2,79,430,219,99,195,649
Pierce27444,104,134,6,13,5,64,509,202,88,238,711
Pierce27445,80,152,7,12,7,75,504,201,101,232,705
Pierce27446,93,125,10,18,14,69,477,191,111,218,668
Pierce27447,95,114,1,10,6,76,476,228,93,209,704
Pierce27448,2,6,0,0,0,0,11,13,0,8,24
Pierce27449,113,137,6,13,11,90,522,275,120,250,797
Pierce27450,127,143,5,13,14,95,550,247,127,270,797
Pierce27451,91,93,1,17,5,76,425,204,99,184,629
Pierce27452,105,119,4,13,6,120,514,265,143,224,779
Pierce27453,88,76,1,10,5,38,412,160,54,164,572
Pierce27454,156,124,13,6,13,97,582,259,129,280,841
Pierce27455,113,80,6,9,5,69,530,230,89,193,760
Pierce27456,137,108,1,13,3,56,542,180,73,245,722
Pierce27457,176,97,2,14,9,73,556,209,98,273,765
Pierce27458,93,74,5,10,6,37,312,178,58,167,490
Pierce27459,70,55,6,15,6,61,310,170,88,125,480
Pierce27460,121,82,6,13,22,123,498,327,164,203,825
Pierce27461,163,93,7,14,46,136,606,372,203,256,978
Pierce27462,117,95,2,15,28,121,527,343,166,212,870
Pierce27463,132,73,4,10,25,117,402,274,156,205,676
Pierce27464,130,79,5,23,14,116,548,311,158,209,859
Pierce27465,100,63,3,15,16,122,509,349,156,163,858
Pierce27466,103,104,4,29,7,96,494,327,136,207,821
Pierce27467,99,102,7,21,12,119,512,373,159,201,885
Pierce27468,98,101,6,15,10,110,458,326,141,199,784
Pierce27469,40,54,0,2,3,18,202,87,23,94,289
Pierce27470,30,43,4,2,0,20,182,59,26,73,241
Pierce27471,7,6,0,0,0,0,42,39,0,13,81
Pierce27475,98,94,7,17,9,109,441,252,142,192,693
Pierce27476,107,61,3,7,15,73,387,200,98,168,587
Pierce27477,93,69,8,26,10,144,382,418,188,162,800
Pierce28501,162,102,5,9,25,142,508,321,181,264,829
Pierce28502,132,99,5,12,22,71,571,230,110,231,801
Pierce28503,209,140,12,20,24,100,656,261,156,349,917
Pierce28504,176,85,5,22,26,119,535,309,172,261,844
Pierce28505,165,109,6,9,30,132,593,325,177,274,918
Pierce28506,177,107,7,26,24,104,598,291,161,284,889
Pierce28507,119,128,5,13,9,107,534,299,134,247,833
Pierce28508,55,84,2,10,14,53,316,157,79,139,473
Pierce28509,0,0,0,0,0,0,0,0,0,0,0
Pierce28515,153,92,6,14,40,134,564,366,194,245,930
Pierce28516,107,90,6,12,11,126,508,330,155,197,838
Pierce28517,128,121,7,21,10,119,590,349,157,249,939
Pierce28518,131,139,14,6,12,113,609,327,145,270,936
Pierce28519,118,107,6,20,19,110,553,324,155,225,877
Pierce28520,154,127,6,14,20,110,573,274,150,281,847
Pierce28521,153,123,7,10,25,123,689,335,165,276,1024
Pierce28522,147,90,1,15,30,146,549,318,192,237,867
Pierce28523,124,65,9,21,34,147,475,375,211,189,850
Pierce28524,129,95,7,24,28,114,553,346,173,224,899
Pierce28525,163,97,5,17,32,121,579,382,175,260,961
Pierce28526,97,93,6,21,26,82,468,251,135,190,719
Pierce28527,153,99,12,20,42,131,601,342,205,252,943
Pierce28528,153,95,4,20,19,123,533,316,166,248,849
Pierce28529,99,69,4,15,13,93,441,280,125,168,721
Pierce28530,61,77,1,6,7,50,352,157,64,138,509
Pierce28531,147,78,3,13,22,117,418,316,155,225,734
Pierce28535,145,115,9,14,15,100,617,320,138,260,937
Pierce28536,113,98,7,19,14,100,527,322,140,211,849
Pierce28537,152,73,7,29,29,109,534,328,174,225,862
Pierce28538,111,87,3,7,21,73,488,264,104,198,752
Pierce28540,148,125,10,26,54,151,519,383,241,273,902
Pierce28541,100,87,14,31,26,108,389,299,179,187,688
Pierce28542,129,91,8,23,38,129,422,312,198,220,734
Pierce28543,105,87,9,14,22,104,362,284,149,192,646
Pierce28545,124,93,8,17,29,128,424,325,182,217,749
Pierce28546,114,67,10,9,29,142,382,311,190,181,693
Pierce28547,154,99,10,17,26,139,605,363,192,253,968
Pierce28548,99,79,6,17,14,118,454,276,155,178,730
Pierce28549,123,57,4,22,30,131,398,319,187,180,717
Pierce28550,101,69,6,17,13,98,331,265,134,170,596
Pierce28551,154,97,10,35,21,175,495,472,241,251,967
Pierce28552,118,109,5,23,30,122,486,329,180,227,815
Pierce28553,112,90,9,21,24,156,457,380,210,202,837
Pierce28554,116,57,4,24,19,162,403,391,209,173,794
Pierce28555,163,92,11,29,26,164,570,436,230,255,1006
Pierce28556,115,84,7,7,8,116,397,318,138,199,715
Pierce28557,104,90,5,20,13,109,401,334,147,194,735
Pierce28558,104,46,6,9,8,105,331,263,128,150,594
Pierce28559,94,52,4,12,24,135,351,337,175,146,688
Pierce28560,122,55,12,23,44,184,406,456,263,177,862
Pierce28561,67,40,6,10,17,84,216,236,117,107,452
Pierce28562,63,60,5,14,8,83,274,244,110,123,518
Pierce28563,50,69,1,3,1,44,226,147,49,119,373
Pierce28565,98,108,7,46,37,102,451,345,192,206,796
Pierce28566,86,66,5,33,29,134,485,406,201,152,891
Pierce28567,100,90,7,34,20,120,384,362,181,190,746
Pierce28568,104,73,10,35,58,148,421,382,251,177,803
Pierce28570,0,0,0,0,0,0,8,5,0,0,13
Pierce28571,0,0,0,0,0,0,3,4,0,0,7
Pierce28572,105,52,6,19,12,109,361,268,146,157,629
Pierce28573,80,77,1,8,7,46,285,139,62,157,424
Pierce28574,13,29,0,23,9,48,163,232,80,42,395
Pierce28575,0,0,0,0,0,0,0,0,0,0,0
Pierce28576,94,116,8,19,19,174,358,372,220,210,730
Pierce28577,0,0,0,0,0,0,14,23,0,0,37
Pierce28578,21,44,3,15,11,32,237,239,61,65,476
Pierce28579,25,40,0,27,9,34,178,218,70,65,396
Pierce28580,12,40,2,33,7,26,139,175,68,52,314
Pierce28581,56,56,6,12,5,78,223,231,101,112,454
Pierce28582,49,28,1,6,4,73,161,169,84,77,330
Pierce28583,56,47,10,7,4,107,195,317,128,103,512
Pierce28584,61,56,8,14,8,95,243,274,125,117,517
Pierce28585,75,58,5,15,5,182,310,460,207,133,770
Pierce28586,76,67,4,26,7,126,310,362,163,143,672
Pierce28587,55,56,3,10,6,114,201,355,133,111,556
Pierce28588,77,68,6,17,13,190,295,485,226,145,780
Pierce28589,60,61,4,16,10,164,244,462,194,121,706
Pierce28590,0,0,0,0,0,0,9,14,0,0,23
Pierce29600,0,0,0,0,0,0,0,0,0,0,0
Pierce29601,65,97,1,8,4,46,397,165,59,162,562
Pierce29602,96,117,3,11,4,75,457,198,93,213,655
Pierce29603,73,70,1,3,2,55,359,157,61,143,516
Pierce29604,122,122,4,12,3,81,499,231,100,244,730
Pierce29605,100,88,7,21,3,74,449,286,105,188,735
Pierce29606,95,122,5,10,8,96,443,308,119,217,751
Pierce29607,154,85,4,15,7,91,540,253,117,239,793
Pierce29608,110,93,6,14,9,70,447,246,99,203,693
Pierce29609,90,75,5,10,10,67,369,204,92,165,573
Pierce29610,125,110,4,12,8,69,479,251,93,235,730
Pierce29611,30,21,2,11,2,15,97,48,30,51,145
Pierce29612,54,80,4,5,5,39,265,113,53,134,378
Pierce29613,103,140,6,20,10,76,505,252,112,243,757
Pierce29614,121,135,4,19,10,69,539,281,102,256,820
Pierce29615,136,89,5,13,10,129,467,308,157,225,775
Pierce29616,112,123,4,11,9,89,488,282,113,235,770
Pierce29617,118,100,13,25,6,103,436,283,147,218,719
Pierce29618,128,60,7,13,1,60,479,207,81,188,686
Pierce29619,110,91,7,10,10,97,434,270,124,201,704
Pierce29620,83,53,1,4,6,51,301,161,62,136,462
Pierce29621,0,0,0,0,0,0,0,0,0,0,0
Pierce29622,99,65,7,8,6,71,378,213,92,164,591
Pierce29623,27,36,0,6,3,16,149,54,25,63,203
Pierce29624,0,0,0,0,0,0,0,0,0,0,0
Pierce29625,0,0,0,0,0,0,7,6,0,0,13
Pierce29626,11,2,0,0,0,0,27,7,0,13,34
Pierce29627,0,0,0,0,0,0,0,0,0,0,0
Pierce29628,58,42,0,11,3,30,254,112,44,100,366
Pierce29629,75,102,0,13,5,22,488,103,40,177,591
Pierce29633,12,3,0,0,0,0,47,22,0,15,69
Pierce29635,40,17,1,8,2,31,116,54,42,57,170
Pierce29636,160,95,9,20,17,113,536,308,159,255,844
Pierce29637,125,74,2,10,15,65,438,220,92,199,658
Pierce29638,75,38,2,13,2,44,204,117,61,113,321
Pierce29639,141,100,3,14,9,90,512,252,116,241,764
Pierce29640,116,82,6,11,6,97,426,271,120,198,697
Pierce29641,125,95,1,16,10,84,512,252,111,220,764
Pierce29642,154,110,2,12,14,114,546,297,142,264,843
Pierce29643,9,11,2,2,0,7,68,34,11,20,102
Pierce29648,4,4,0,0,0,0,11,13,0,8,24
Pierce29649,41,30,1,3,0,20,226,83,24,71,309
Pierce29650,121,94,2,12,6,106,502,323,126,215,825
Pierce29651,119,95,5,20,4,123,465,346,152,214,811
Pierce29652,8,15,1,8,0,14,71,44,23,23,115
Pierce29653,128,104,6,4,8,101,414,264,119,232,678
Pierce29654,102,126,6,13,8,100,512,319,127,228,831
Pierce29655,57,50,3,1,5,37,244,113,46,107,357
Pierce29656,90,52,1,12,15,98,281,238,126,142,519
Pierce29657,0,0,0,0,0,0,3,4,0,0,7
Pierce29658,120,65,2,24,10,119,379,349,155,185,728
Pierce29659,67,54,7,6,2,70,228,176,85,121,404
Pierce29660,122,72,7,23,10,147,417,387,187,194,804
Pierce29661,92,50,2,13,7,123,298,296,145,142,594
Pierce29662,0,0,0,0,0,0,0,0,0,0,0
Pierce29663,89,63,6,22,13,91,331,320,132,152,651
Pierce29664,109,49,8,8,13,137,318,331,166,158,649
Pierce29667,79,66,2,19,16,149,336,386,186,145,722
Pierce29668,68,63,2,14,4,104,238,304,124,131,542
Pierce29669,104,82,3,9,12,122,355,377,146,186,732
Pierce29670,85,93,9,28,7,133,347,412,177,178,759
Pierce29671,72,71,7,16,10,123,335,371,156,143,706
Pierce29672,59,40,5,14,7,78,242,226,104,99,468
Pierce29673,107,86,3,13,9,154,528,434,179,193,962
Pierce29674,42,31,4,10,3,63,159,143,80,73,302
Pierce29675,115,63,6,19,12,136,426,376,173,178,802
Pierce29676,113,94,5,25,13,114,527,406,157,207,933
Pierce29677,97,78,10,30,20,142,454,443,202,175,897
Pierce29678,83,66,3,18,7,103,344,293,131,149,637
Pierce29679,86,65,8,12,6,139,455,417,165,151,872
Pierce29680,82,66,6,13,7,111,302,378,137,148,680
Pierce29682,130,79,2,6,5,117,418,296,130,209,714
Pierce29683,109,80,4,26,3,108,393,316,141,189,709
Pierce30701,0,0,0,0,0,0,6,18,0,0,24
Pierce30705,46,40,4,13,0,67,204,199,84,86,403
Pierce30706,76,74,2,17,7,101,259,294,127,150,553
Pierce30707,32,30,3,7,1,67,162,174,78,62,336
Pierce30708,56,64,5,13,7,82,270,265,107,120,535
Pierce30709,92,63,9,21,14,77,352,241,121,155,593
Pierce30713,0,0,0,0,0,0,3,5,0,0,8
Pierce31801,34,45,5,7,4,80,172,235,96,79,407
Pierce31802,69,42,6,19,8,113,263,336,146,111,599
Pierce31803,66,58,3,5,13,108,303,314,129,124,617
Pierce31804,67,49,1,9,10,89,293,282,109,116,575
Pierce31805,73,51,7,16,13,103,291,280,139,124,571
Pierce31806,89,51,6,9,17,120,339,342,152,140,681
Pierce31807,0,0,0,0,0,0,6,3,0,0,9
Pierce31808,69,52,6,10,10,110,276,292,136,121,568
Pierce31809,64,57,4,10,11,103,257,350,128,121,607
Pierce31810,39,34,0,7,8,56,172,169,71,73,341
Pierce31813,52,27,1,10,10,44,193,134,65,79,327
Pierce31814,12,24,0,0,3,25,105,60,28,36,165
Pierce31815,72,51,4,9,6,57,322,200,76,123,522
Pierce31816,100,48,5,11,16,99,350,259,131,148,609
Pierce31817,119,111,5,30,20,131,623,466,186,230,1089
Pierce31818,27,31,3,8,6,26,151,110,43,58,261
Pierce31819,32,34,0,7,8,42,139,134,57,66,273
Pierce31822,61,51,11,9,4,84,239,250,108,112,489
Pierce31823,45,56,6,16,9,108,240,292,139,101,532
Pierce31824,0,0,0,0,0,0,0,0,0,0,0
Pierce31825,71,80,5,14,4,94,298,273,117,151,571
Pierce31826,90,55,6,17,7,121,318,264,151,145,582
Pierce31827,15,10,2,4,8,31,59,79,45,25,138
Pierce31828,81,66,4,12,18,84,316,231,118,147,547
Pierce31829,56,81,5,17,15,83,312,281,120,137,593
Pierce31830,42,42,2,7,3,39,133,138,51,84,271
Pierce31832,60,47,0,10,7,83,251,321,100,107,572
Pierce31833,58,56,5,19,15,89,275,330,128,114,605
Pierce31834,46,54,1,7,17,94,240,312,119,100,552
Pierce31835,39,55,2,6,9,95,229,301,112,94,530
Pierce31836,50,62,8,18,11,161,270,416,198,112,686
Pierce31837,57,69,4,19,11,95,274,307,129,126,581
Pierce31838,44,56,5,15,7,75,209,286,102,100,495
Pierce31839,5,9,1,2,2,5,27,28,10,14,55
Pierce31840,28,29,3,10,7,64,124,197,84,57,321
Pierce31841,47,53,2,15,8,67,192,229,92,100,421
Pierce31842,46,55,0,23,6,92,248,364,121,101,612
Pierce31843,42,53,5,13,2,91,217,290,111,95,507
Pierce31844,22,43,3,3,5,62,215,284,73,65,499
Pierce31845,56,54,1,23,16,75,233,289,115,110,522
Pierce31846,18,27,5,7,1,51,105,173,64,45,278
Pierce31847,24,28,3,8,6,52,143,175,69,52,318
Pierce31848,10,8,0,6,3,18,51,66,27,18,117
Pierce31849,29,24,4,6,2,65,116,180,77,53,296
Pierce31853,10,10,2,4,2,22,52,77,30,20,129
Pierce31854,26,36,4,11,7,54,118,161,76,62,279
Pierce31855,41,29,2,10,5,76,151,246,93,70,397
Pierce31856,56,53,3,7,15,121,226,342,146,109,568
Pierce31857,32,46,5,7,3,78,153,224,93,78,377
Pierce31861,21,6,0,2,2,49,66,121,53,27,187
Pierce31865,16,18,1,4,5,30,67,114,40,34,181
Pierce31869,24,24,2,5,6,66,81,197,79,48,278
Pierce31873,8,6,1,2,0,33,49,84,36,14,133
Pierce31874,0,0,0,0,0,0,0,0,0,0,0
Pierce31875,68,58,7,22,12,148,316,459,189,126,775
Pierce31876,9,5,0,0,0,0,13,28,0,14,41
Pierce31877,36,25,1,3,6,62,166,182,72,61,348
Pierce31879,12,18,2,4,2,30,75,106,38,30,181
Pierce31880,19,21,4,6,8,42,140,127,60,40,267
Pierce31881,43,31,0,4,8,75,203,276,87,74,479
Pierce31882,66,45,12,9,17,131,275,370,169,111,645
Pierce31883,71,64,10,12,26,147,321,422,195,135,743
Pierce31884,49,42,1,18,16,159,262,467,194,91,729
Pierce31885,29,13,2,4,4,35,112,120,45,42,232
Pierce31886,67,56,5,14,10,112,281,350,141,123,631
Pierce31887,63,46,2,8,16,113,267,313,139,109,580
Pierce31888,38,40,1,13,4,107,188,291,125,78,479
Pierce31890,23,41,3,2,5,64,159,195,74,64,354
Pierce31891,31,15,0,1,8,41,76,102,50,46,178
Pierce31892,49,34,5,13,10,87,228,259,115,83,487
Pierce31893,0,0,0,0,0,0,0,0,0,0,0
Pierce31894,11,5,0,4,1,13,37,49,18,16,86
Pierce31895,35,40,12,4,10,108,167,341,134,75,508
Pierce31896,0,0,0,0,0,0,7,8,0,0,15
Pierce31897,23,25,0,9,3,56,155,219,68,48,374
Pierce31898,76,45,18,12,10,164,239,412,204,121,651
Pierce31899,47,32,5,17,3,74,170,209,99,79,379
Pierce31900,62,32,2,12,16,113,179,226,143,94,405
Pierce31901,11,6,0,0,0,0,28,33,0,17,61
Pierce31902,127,90,6,16,22,131,543,527,175,217,1070
Pierce31903,0,0,0,0,0,0,8,8,0,0,16
Pierce31904,16,6,0,0,3,26,38,94,29,22,132
Pierce31905,50,58,9,9,7,91,228,340,116,108,568
Pierce31906,37,29,1,7,4,61,121,203,73,66,324
Pierce31907,43,50,8,18,6,104,200,320,136,93,520
Pierce31908,31,59,6,8,9,72,201,253,95,90,454
Pierce31909,59,45,7,11,5,86,194,294,109,104,488
Pierce31910,66,50,5,9,4,83,217,298,101,116,515
Pierce31911,45,26,5,4,1,65,155,191,75,71,346
Pierce31912,24,53,3,11,3,87,167,271,104,77,438
Pierce31913,16,24,3,6,2,58,82,181,69,40,263
Pierce31914,36,39,5,8,3,85,166,255,101,75,421
Pierce31915,7,9,2,4,2,26,34,65,34,16,99
Pierce31916,56,29,6,21,7,103,238,314,137,85,552
Pierce31917,68,60,9,18,21,169,268,522,217,128,790
Pierce31919,50,52,3,12,7,96,228,310,118,102,538
Pierce31920,41,53,3,15,9,89,183,241,116,94,424
Pierce31921,44,35,5,16,4,111,154,353,136,79,507
Pierce31923,25,41,2,7,8,117,154,339,134,66,493
Pierce31924,29,41,9,21,2,95,111,269,127,70,380
Pierce31925,22,23,2,0,4,25,86,60,31,45,146
Pierce31926,3,4,0,0,0,0,18,7,0,7,25
Pierce31927,25,54,5,16,3,111,164,361,135,79,525
Pierce31928,49,34,6,14,6,94,204,284,120,83,488
San Juan101,85,167,7,8,15,78,431,210,108,252,641
San Juan102,57,127,2,6,7,64,317,148,79,184,465
San Juan11,92,89,2,5,18,56,287,132,81,181,419
San Juan12,127,156,2,5,23,76,490,164,106,283,654
San Juan13,100,193,1,13,16,66,480,176,96,293,656
San Juan14,111,184,3,9,12,94,448,176,118,295,624
San Juan15,99,112,7,6,21,122,348,216,156,211,564
San Juan16,86,129,5,8,6,55,364,137,74,215,501
San Juan17,62,52,7,7,7,47,190,97,68,114,287
San Juan21,6,44,0,0,3,3,72,10,6,50,82
San Juan22,156,214,3,16,29,79,605,202,127,370,807
San Juan23,171,226,3,16,31,65,589,164,115,397,753
San Juan24,143,291,3,17,19,97,631,205,136,434,836
San Juan25,143,215,4,19,23,83,519,180,129,358,699
San Juan26,2,5,0,0,3,7,19,17,10,7,36
San Juan31,231,259,3,15,31,114,701,230,163,490,931
San Juan32,154,216,3,6,8,87,556,156,104,370,712
San Juan33,7,10,2,3,1,13,29,26,19,17,55
San Juan41,28,40,1,11,1,7,96,42,20,68,138
Skagit101,42,37,4,3,5,83,116,190,95,79,306
Skagit102,41,44,1,16,7,78,140,201,102,85,341
Skagit103,18,27,3,7,6,61,91,183,77,45,274
Skagit104,11,23,2,4,1,14,55,55,21,34,110
Skagit105,62,60,3,8,5,89,248,236,105,122,484
Skagit107,73,86,4,16,3,132,251,313,155,159,564
Skagit108,75,76,5,12,10,76,249,220,103,151,469
Skagit109,38,36,4,8,5,80,134,202,97,74,336
Skagit110,96,88,4,16,21,163,333,413,204,184,746
Skagit111,51,66,12,9,3,176,163,377,200,117,540
Skagit113,88,105,3,9,27,105,322,328,144,193,650
Skagit114,26,30,0,9,0,14,82,42,23,56,124
Skagit115,5,25,1,7,8,31,80,100,47,30,180
Skagit116,52,73,10,25,9,109,225,318,153,125,543
Skagit117,29,31,2,2,8,59,91,116,71,60,207
Skagit118,28,48,3,16,0,31,122,116,50,76,238
Skagit119,158,153,10,27,28,181,527,446,246,311,973
Skagit120,4,7,1,2,3,13,13,32,19,11,45
Skagit121,51,33,3,4,1,29,130,92,37,84,222
Skagit122,48,55,1,8,4,73,182,146,86,103,328
Skagit124,34,34,1,12,7,46,118,115,66,68,233
Skagit125,31,37,1,5,6,74,105,170,86,68,275
Skagit126,64,53,5,13,11,172,234,399,201,117,633
Skagit127,90,132,4,6,13,72,367,117,95,222,484
Skagit128,25,29,1,4,6,27,114,85,38,54,199
Skagit129,48,42,1,3,10,57,178,151,71,90,329
Skagit130,25,27,1,3,10,49,119,144,63,52,263
Skagit132,71,86,2,20,17,119,305,325,158,157,630
Skagit133,11,20,0,0,0,0,54,55,0,31,109
Skagit134,20,30,1,1,5,32,99,97,39,50,196
Skagit135,2,7,0,2,1,5,21,15,8,9,36
Skagit136,29,40,1,7,3,67,154,178,78,69,332
Skagit137,105,77,11,20,10,194,316,493,235,182,809
Skagit138,32,13,2,2,3,25,69,72,32,45,141
Skagit139,49,46,3,4,3,79,129,223,89,95,352
Skagit140,104,103,3,15,22,167,358,407,207,207,765
Skagit141,37,62,1,3,5,66,149,176,75,99,325
Skagit144,69,60,3,9,15,100,252,261,127,129,513
Skagit145,28,73,10,30,9,122,190,364,171,101,554
Skagit146,71,70,4,8,11,72,265,174,95,141,439
Skagit147,53,35,6,5,12,76,175,191,99,88,366
Skagit148,63,85,7,12,5,84,231,192,108,148,423
Skagit149,133,97,1,12,21,151,353,282,185,230,635
Skagit150,78,97,3,10,11,83,291,176,107,175,467
Skagit151,9,24,0,2,1,38,58,98,41,33,156
Skagit153,117,106,3,15,17,75,444,180,110,223,624
Skagit154,30,41,1,4,6,67,113,182,78,71,295
Skagit155,57,40,4,22,4,125,164,304,155,97,468
Skagit156,44,45,6,8,4,79,166,209,97,89,375
Skagit157,48,26,0,4,4,37,126,76,45,74,202
Skagit158,110,113,7,12,27,153,395,382,199,223,777
Skagit159,110,88,4,17,14,190,391,377,225,198,768
Skagit160,31,60,7,10,14,116,203,326,147,91,529
Skagit164,87,104,1,16,24,151,337,318,192,191,655
Skagit165,9,17,0,4,2,41,79,76,47,26,155
Skagit166,43,53,10,6,4,99,144,231,119,96,375
Skagit167,30,34,4,9,4,79,118,195,96,64,313
Skagit168,80,94,7,6,13,102,0,0,128,174,0
Skagit170,0,0,0,0,0,0,0,0,0,0,0
Skagit171,14,17,4,2,3,52,62,112,61,31,174
Skagit172,34,23,4,14,4,59,100,134,81,57,234
Skagit173,0,0,0,0,0,0,10,14,0,0,24
Skagit174,10,14,3,5,4,33,74,72,45,24,146
Skagit176,17,17,4,1,1,24,54,49,30,34,103
Skagit201,101,142,2,6,6,78,354,178,92,243,532
Skagit204,68,89,0,5,5,68,256,148,78,157,404
Skagit205,0,0,0,3,0,7,10,11,10,0,21
Skagit206,86,92,1,17,18,97,280,242,133,178,522
Skagit207,152,212,10,28,31,171,589,452,240,364,1041
Skagit209,91,97,7,12,18,111,319,259,148,188,578
Skagit211,140,126,5,10,22,119,452,295,156,266,747
Skagit217,189,219,6,19,23,156,652,349,204,408,1001
Skagit220,145,143,7,21,47,171,472,364,246,288,836
Skagit221,129,121,13,15,28,146,369,335,202,250,704
Skagit222,143,117,1,26,22,152,438,349,201,260,787
Skagit223,70,36,5,9,23,89,203,178,126,106,381
Skagit224,201,123,7,22,43,249,528,461,321,324,989
Skagit225,61,62,6,11,17,82,231,203,116,123,434
Skagit301,34,66,1,7,1,34,160,84,43,100,244
Skagit302,24,66,2,8,6,35,160,115,51,90,275
Skagit303,91,95,4,13,4,68,332,236,89,186,568
Skagit304,117,124,10,13,15,144,461,372,182,241,833
Skagit305,17,35,4,1,1,38,118,94,44,52,212
Skagit306,72,118,3,4,8,46,357,131,61,190,488
Skagit307,104,109,2,12,14,49,382,152,77,213,534
Skagit308,154,144,8,22,29,187,522,424,246,298,946
Skagit309,39,58,6,4,11,43,185,114,64,97,299
Skagit310,51,63,0,8,2,41,234,122,51,114,356
Skagit311,108,75,9,5,9,86,285,204,109,183,489
Skagit312,60,40,0,2,8,49,164,120,59,100,284
Skagit314,128,112,6,17,16,140,426,301,179,240,727
Skagit315,49,53,3,8,6,64,253,156,81,102,409
Skagit316,125,111,9,15,14,165,391,351,203,236,742
Skagit319,85,88,6,10,13,110,336,287,139,173,623
Skagit321,150,146,11,19,19,176,574,424,225,296,998
Skagit322,108,80,7,13,8,100,308,257,128,188,565
Skagit323,75,91,10,15,18,94,377,341,137,166,718
Skagit326,0,0,0,0,0,0,0,0,0,0,0
Skagit327,26,13,4,11,5,32,65,72,52,39,137
Skagit330,107,97,10,15,16,112,375,349,153,204,724
Skagit331,0,0,0,0,0,0,0,0,0,0,0
Skagit401,70,73,6,22,11,112,269,333,151,143,602
Skagit402,78,75,12,19,9,135,264,365,175,153,629
Skagit403,54,84,3,18,2,80,219,205,103,138,424
Skagit404,70,102,4,14,7,124,262,319,149,172,581
Skagit405,100,120,9,25,13,157,363,421,204,220,784
Skagit406,62,101,3,18,6,118,232,283,145,163,515
Skagit407,3,4,0,0,0,0,8,6,0,7,14
Skagit408,0,0,0,0,0,0,0,0,0,0,0
Skagit501,35,64,3,2,0,45,168,122,50,99,290
Skagit502,52,47,5,9,3,56,184,172,73,99,356
Skagit503,20,37,0,4,2,23,109,58,29,57,167
Skagit504,47,53,2,10,8,96,186,219,116,100,405
Skagit505,77,69,6,7,11,127,288,315,151,146,603
Skagit506,59,58,6,5,8,76,199,194,95,117,393
Skagit507,44,43,7,8,9,89,163,192,113,87,355
Skagit508,0,0,0,0,0,0,0,0,0,0,0
Skagit601,32,39,3,8,4,66,101,119,81,71,220
Skagit701,5,6,0,0,0,0,18,56,0,11,74
Skagit801,118,115,4,9,3,74,398,162,90,233,560
Skagit855,20,18,0,0,0,0,52,98,0,38,150
Skamania100,24,26,2,1,7,78,81,197,88,50,278
Skamania101,29,31,5,8,3,46,114,133,62,60,247
Skamania102,29,42,2,11,3,58,105,141,74,71,246
Skamania103,23,33,0,0,0,0,93,206,0,56,299
Skamania104,2,6,0,0,0,0,14,20,0,8,34
Skamania105,26,40,3,10,9,58,103,168,80,66,271
Skamania106,0,0,1,20,3,87,138,185,111,0,323
Skamania201,0,0,0,0,2,6,7,9,8,0,16
Skamania202,46,79,4,11,3,113,175,223,131,125,398
Skamania203,28,29,2,3,6,42,75,104,53,57,179
Skamania204,53,57,3,2,16,58,168,156,79,110,324
Skamania205,28,55,5,3,11,41,123,105,60,83,228
Skamania206,14,27,0,1,2,22,51,33,25,41,84
Skamania207,16,27,3,5,1,25,69,61,34,43,130
Skamania208,33,51,7,5,3,82,129,182,97,84,311
Skamania300,27,53,2,11,4,105,107,211,122,80,318
Skamania303,27,39,2,5,1,73,92,161,81,66,253
Skamania304,10,13,2,5,2,30,44,86,39,23,130
Skamania305,28,31,3,2,2,50,81,121,57,59,202
Skamania307,22,19,1,3,5,46,70,98,55,41,168
Skamania309,17,35,4,10,5,51,85,124,70,52,209
Skamania310,47,44,3,5,6,67,153,124,81,91,277
Skamania311,40,50,2,3,9,31,155,80,45,90,235
Snohomish10141598,86,52,6,8,17,45,345,159,76,138,504
Snohomish10141599,45,64,2,9,12,42,319,135,65,109,454
Snohomish10141600,86,70,0,4,7,82,378,186,93,156,564
Snohomish10141601,87,69,4,14,20,47,355,165,85,156,520
Snohomish10141602,62,47,4,8,10,63,251,141,85,109,392
Snohomish10141603,56,53,5,5,8,48,308,174,66,109,482
Snohomish10141604,65,65,6,15,14,92,363,235,127,130,598
Snohomish10141605,68,63,1,14,12,43,298,129,70,131,427
Snohomish10141606,39,46,3,8,16,34,224,138,61,85,362
Snohomish10141607,64,85,13,11,11,58,344,178,93,149,522
Snohomish10141608,84,71,5,7,6,75,344,183,93,155,527
Snohomish10141609,90,75,4,10,17,87,393,188,118,165,581
Snohomish10141610,61,62,0,1,7,46,251,122,54,123,373
Snohomish10141611,48,68,2,11,10,26,248,98,49,116,346
Snohomish10141612,37,59,4,3,13,40,212,104,60,96,316
Snohomish10141613,95,49,4,12,13,105,197,173,134,144,370
Snohomish10141644,76,61,3,5,6,54,356,194,68,137,550
Snohomish10144165,81,74,3,7,11,68,458,200,89,155,658
Snohomish10144171,23,24,1,8,1,61,121,164,71,47,285
Snohomish10144266,66,80,1,6,6,60,292,151,73,146,443
Snohomish10144271,77,69,6,5,12,72,490,219,95,146,709
Snohomish10144330,52,50,0,12,13,61,297,269,86,102,566
Snohomish10144338,64,39,4,4,11,41,351,122,60,103,473
Snohomish10144370,60,38,3,21,6,87,237,229,117,98,466
Snohomish10144426,60,61,0,5,11,74,392,218,90,121,610
Snohomish10144479,50,41,4,5,9,36,222,131,54,91,353
Snohomish10144484,41,43,2,6,7,34,275,126,49,84,401
Snohomish10144552,84,81,4,13,27,75,483,216,119,165,699
Snohomish10144559,20,15,0,3,1,12,79,66,16,35,145
Snohomish10144581,63,44,3,14,8,72,295,213,97,107,508
Snohomish10144592,76,48,5,21,18,95,354,265,139,124,619
Snohomish10144594,69,66,1,14,15,91,343,296,121,135,639
Snohomish10144597,41,28,2,6,10,49,148,202,67,69,350
Snohomish10144635,61,58,2,9,6,35,280,106,52,119,386
Snohomish10144639,55,53,4,13,4,71,248,154,92,108,402
Snohomish10144646,57,52,3,8,15,53,311,141,79,109,452
Snohomish10144656,77,69,1,8,5,74,449,259,88,146,708
Snohomish10144685,63,44,1,5,12,37,311,119,55,107,430
Snohomish10144691,27,49,1,7,5,31,193,110,44,76,303
Snohomish10144715,65,39,3,8,8,41,326,167,60,104,493
Snohomish10144762,84,50,3,7,19,68,517,188,97,134,705
Snohomish10144763,19,17,1,4,2,28,164,87,35,36,251
Snohomish10154009,46,48,0,10,6,63,190,151,79,94,341
Snohomish10154026,54,66,13,15,3,64,247,213,95,120,460
Snohomish10154032,40,34,0,6,3,55,161,145,64,74,306
Snohomish10154062,63,70,2,13,13,73,277,242,101,133,519
Snohomish10154170,77,80,5,10,11,82,260,174,108,157,434
Snohomish10154178,45,66,5,6,8,77,271,269,96,111,540
Snohomish10154273,30,19,1,5,6,31,139,99,43,49,238
Snohomish10154283,58,59,3,8,14,80,258,225,105,117,483
Snohomish10154310,54,49,4,19,12,97,219,273,132,103,492
Snohomish10154329,63,60,2,19,20,88,333,287,129,123,620
Snohomish10154333,116,60,1,17,22,79,393,234,119,176,627
Snohomish10154334,31,49,5,8,20,74,174,205,107,80,379
Snohomish10154369,40,38,0,5,9,44,153,172,58,78,325
Snohomish10154372,79,63,2,19,8,81,320,252,110,142,572
Snohomish10154375,51,41,0,7,2,39,191,113,48,92,304
Snohomish10154387,37,44,2,11,14,46,189,154,73,81,343
Snohomish10154435,22,17,4,3,4,32,96,100,43,39,196
Snohomish10154535,50,25,1,7,7,44,147,110,59,75,257
Snohomish10154551,44,46,4,13,3,49,169,182,69,90,351
Snohomish10154560,67,52,3,20,7,104,266,293,134,119,559
Snohomish10154579,0,0,0,0,0,0,26,23,0,0,49
Snohomish10154657,38,33,2,7,5,57,144,123,71,71,267
Snohomish11014016,48,69,10,16,2,114,222,352,142,117,574
Snohomish11014021,22,20,0,3,1,23,68,94,27,42,162
Snohomish11014027,18,26,5,8,6,82,97,216,101,44,313
Snohomish11014326,30,32,0,6,4,63,111,163,73,62,274
Snohomish11014647,52,82,10,15,3,109,196,320,137,134,516
Snohomish11014759,18,35,0,12,2,55,93,165,69,53,258
Snohomish13911384,53,63,5,6,3,83,188,236,97,116,424
Snohomish13911385,50,60,7,12,6,99,222,278,124,110,500
Snohomish13911637,48,44,5,9,7,119,170,303,140,92,473
Snohomish13911670,20,22,0,4,0,40,76,104,44,42,180
Snohomish13911760,0,0,0,0,0,0,0,0,0,0,0
Snohomish13914011,37,39,2,16,4,91,140,275,113,76,415
Snohomish13914015,43,52,5,11,4,74,130,211,94,95,341
Snohomish13914028,31,59,3,6,6,77,130,238,92,90,368
Snohomish13914033,36,29,1,8,2,37,140,129,48,65,269
Snohomish13914034,42,67,2,5,2,108,193,281,117,109,474
Snohomish13914035,33,34,0,16,7,39,134,121,62,67,255
Snohomish13914042,52,49,5,15,12,125,210,365,157,101,575
Snohomish13914053,47,58,6,12,9,116,187,295,143,105,482
Snohomish13914057,46,53,3,10,7,86,184,247,106,99,431
Snohomish13914060,29,28,2,7,5,59,93,184,73,57,277
Snohomish13914069,27,39,0,6,4,56,164,191,66,66,355
Snohomish13914211,27,15,1,3,3,65,66,145,72,42,211
Snohomish13914264,41,43,15,15,11,56,179,236,97,84,415
Snohomish13914270,65,54,6,13,17,107,209,311,143,119,520
Snohomish13914275,29,46,4,14,4,84,194,229,106,75,423
Snohomish13914321,51,41,0,15,10,73,173,213,98,92,386
Snohomish13914347,43,49,1,24,11,95,149,248,131,92,397
Snohomish13914374,57,73,4,13,8,93,218,247,118,130,465
Snohomish13914416,46,31,4,11,7,75,154,193,97,77,347
Snohomish13914433,18,26,0,5,6,55,73,153,66,44,226
Snohomish13914439,2,3,0,0,0,0,5,6,0,5,11
Snohomish13914470,35,51,2,7,4,74,189,206,87,86,395
Snohomish13914496,31,17,2,3,2,29,68,88,36,48,156
Snohomish13914515,10,42,2,0,2,38,96,147,42,52,243
Snohomish13914517,50,40,6,10,5,134,176,339,155,90,515
Snohomish13914519,37,34,3,5,4,82,128,237,94,71,365
Snohomish13914521,70,59,9,9,12,94,257,285,124,129,542
Snohomish13914529,43,22,5,16,8,74,140,248,103,65,388
Snohomish13914533,28,28,2,1,2,41,88,128,46,56,216
Snohomish13914555,40,35,4,12,4,58,126,192,78,75,318
Snohomish13914557,40,64,2,7,4,85,174,219,98,104,393
Snohomish13914573,5,7,3,2,4,44,39,105,53,12,144
Snohomish13914583,12,27,0,0,2,22,63,59,24,39,122
Snohomish13914681,60,67,3,7,5,138,187,280,153,127,467
Snohomish13914683,25,31,3,8,11,53,101,147,75,56,248
Snohomish13951039,14,31,0,0,3,16,51,31,19,45,82
Snohomish13951054,74,76,4,12,6,73,277,213,95,150,490
Snohomish13951055,43,77,7,16,7,90,272,301,120,120,573
Snohomish13951070,46,54,4,18,0,102,182,259,124,100,441
Snohomish13951071,44,69,4,18,2,66,179,229,90,113,408
Snohomish13951187,74,57,2,11,9,94,275,231,116,131,506
Snohomish13951188,49,95,1,16,12,85,305,286,114,144,591
Snohomish13951322,38,70,6,7,11,90,191,256,114,108,447
Snohomish13951431,60,66,4,13,9,81,272,247,107,126,519
Snohomish13951506,55,56,3,7,7,54,211,192,71,111,403
Snohomish13951548,34,64,7,15,6,62,205,249,90,98,454
Snohomish13951566,50,46,1,11,3,68,152,203,83,96,355
Snohomish13951567,32,69,3,18,2,75,141,214,98,101,355
Snohomish13951568,40,34,3,5,4,61,163,160,73,74,323
Snohomish13951586,24,68,6,26,9,62,264,254,103,92,518
Snohomish13951587,16,15,1,11,4,23,84,78,39,31,162
Snohomish13951653,69,41,4,26,16,85,279,295,131,110,574
Snohomish13951654,33,28,4,14,4,55,145,159,77,61,304
Snohomish13951713,19,63,1,10,3,66,157,200,80,82,357
Snohomish13954003,20,28,3,9,6,46,77,119,64,48,196
Snohomish13954005,56,52,1,13,7,93,216,239,114,108,455
Snohomish13954007,51,51,0,13,6,61,214,155,80,102,369
Snohomish13954008,28,48,0,7,3,68,150,183,78,76,333
Snohomish13954010,64,64,6,11,13,100,243,328,130,128,571
Snohomish13954013,77,55,5,13,24,64,292,237,106,132,529
Snohomish13954031,34,40,6,2,12,61,151,218,81,74,369
Snohomish13954036,34,26,0,5,6,45,123,132,56,60,255
Snohomish13954041,17,19,0,3,8,27,83,60,38,36,143
Snohomish13954043,46,63,5,14,7,133,195,306,159,109,501
Snohomish13954058,11,50,3,7,4,58,71,150,72,61,221
Snohomish13954064,53,32,4,13,6,60,175,188,83,85,363
Snohomish13954272,41,48,3,7,9,79,194,225,98,89,419
Snohomish13954292,53,71,10,27,12,136,297,337,185,124,634
Snohomish13954309,35,35,1,16,11,69,181,224,97,70,405
Snohomish13954340,44,45,4,25,7,90,194,268,126,89,462
Snohomish13954371,51,82,12,20,10,105,257,341,147,133,598
Snohomish13954388,52,46,1,13,9,99,202,263,122,98,465
Snohomish13954417,20,53,1,8,3,90,149,249,102,73,398
Snohomish13954425,48,52,6,11,4,70,171,202,91,100,373
Snohomish13954442,64,59,5,13,11,99,251,277,128,123,528
Snohomish13954443,33,51,3,13,7,71,172,206,94,84,378
Snohomish13954454,39,50,3,8,5,65,191,174,81,89,365
Snohomish13954469,46,95,3,11,5,113,227,260,132,141,487
Snohomish13954471,37,73,5,9,10,83,198,252,107,110,450
Snohomish13954487,74,79,5,18,9,116,301,330,148,153,631
Snohomish13954507,46,51,2,9,9,78,179,229,98,97,408
Snohomish13954526,13,15,3,1,1,37,46,84,42,28,130
Snohomish13954534,32,38,2,7,6,49,136,129,64,70,265
Snohomish13954537,35,51,4,14,7,64,183,194,89,86,377
Snohomish13954553,30,55,2,9,4,61,146,190,76,85,336
Snohomish13954710,36,23,4,7,4,42,130,122,57,59,252
Snohomish13954750,12,21,4,2,0,35,48,73,41,33,121
Snohomish13954753,5,6,0,0,0,0,17,8,0,11,25
Snohomish13954754,14,14,0,2,4,32,74,87,38,28,161
Snohomish14414044,15,26,4,4,1,30,70,80,39,41,150
Snohomish14414318,27,33,0,5,9,59,98,190,73,60,288
Snohomish14414522,48,37,4,18,5,75,162,246,102,85,408
Snohomish14441301,129,49,1,11,22,87,349,201,121,178,550
Snohomish14441302,47,34,3,7,10,56,203,158,76,81,361
Snohomish14441303,35,42,3,10,8,33,188,115,54,77,303
Snohomish14441304,68,39,4,5,22,49,210,141,80,107,351
Snohomish14441353,108,43,2,15,19,101,322,207,137,151,529
Snohomish14441354,91,48,4,5,23,66,361,219,98,139,580
Snohomish14441367,5,2,0,2,1,8,30,22,11,7,52
Snohomish14441376,100,51,5,14,18,86,325,193,123,151,518
Snohomish14441377,80,63,0,7,13,51,343,170,71,143,513
Snohomish14441472,54,51,2,5,9,52,310,152,68,105,462
Snohomish14441473,47,28,0,1,12,59,212,134,72,75,346
Snohomish14441495,39,29,2,7,13,61,172,171,83,68,343
Snohomish14441505,67,79,0,8,12,64,345,190,84,146,535
Snohomish14441629,5,2,0,0,0,0,13,9,0,7,22
Snohomish14441640,72,65,1,12,13,53,366,147,79,137,513
Snohomish14441652,44,18,1,1,15,44,195,136,61,62,331
Snohomish14441665,52,56,1,13,9,58,282,167,81,108,449
Snohomish14441666,50,47,4,11,2,49,276,172,66,97,448
Snohomish14441667,79,46,0,14,9,51,323,174,74,125,497
Snohomish14441668,57,30,2,8,16,61,199,147,87,87,346
Snohomish14441702,43,16,1,1,4,30,148,82,36,59,230
Snohomish14441703,59,65,2,4,6,39,313,161,51,124,474
Snohomish14441771,59,43,2,5,7,31,279,148,45,102,427
Snohomish14444006,52,52,1,18,4,49,299,152,72,104,451
Snohomish14444278,65,82,6,5,9,57,358,188,77,147,546
Snohomish14444293,44,35,4,6,2,53,226,145,65,79,371
Snohomish14444298,52,43,3,7,7,75,207,197,92,95,404
Snohomish14444305,67,62,2,9,4,54,302,152,69,129,454
Snohomish14444308,50,74,6,9,7,69,281,216,91,124,497
Snohomish14444317,61,34,2,7,8,45,250,143,62,95,393
Snohomish14444348,42,47,4,16,10,30,287,141,60,89,428
Snohomish14444357,51,46,1,9,6,34,231,138,50,97,369
Snohomish14444361,45,61,0,9,12,58,359,207,79,106,566
Snohomish14444547,29,33,6,5,3,49,154,166,63,62,320
Snohomish14444575,42,38,4,9,6,57,238,175,76,80,413
Snohomish14444576,52,33,2,11,13,39,253,119,65,85,372
Snohomish14444582,66,70,2,15,6,65,364,220,88,136,584
Snohomish14444584,83,45,3,13,13,62,402,214,91,128,616
Snohomish14444590,62,68,9,13,12,45,326,218,79,130,544
Snohomish14444595,71,52,3,17,8,57,338,181,85,123,519
Snohomish14444658,21,32,1,10,7,29,129,111,47,53,240
Snohomish14444659,37,45,6,9,11,54,288,196,80,82,484
Snohomish14444660,53,68,3,11,10,62,431,227,86,121,658
Snohomish14444684,49,70,1,6,3,50,387,192,60,119,579
Snohomish14444693,52,51,1,10,6,42,364,150,59,103,514
Snohomish14451014,40,69,5,19,18,76,284,257,118,109,541
Snohomish14451038,53,56,2,9,14,42,249,141,67,109,390
Snohomish14451056,101,97,4,21,10,80,388,256,115,198,644
Snohomish14451134,58,60,8,11,17,79,280,260,115,118,540
Snohomish14451135,64,43,4,5,9,75,215,215,93,107,430
Snohomish14451144,69,81,3,12,7,65,263,193,87,150,456
Snohomish14451145,68,90,8,15,8,83,280,273,114,158,553
Snohomish14451349,62,105,4,14,12,77,311,289,107,167,600
Snohomish14451418,43,43,6,8,7,73,190,212,94,86,402
Snohomish14451436,41,58,4,3,3,57,173,154,67,99,327
Snohomish14451437,52,93,0,9,2,66,226,161,77,145,387
Snohomish14451438,32,23,5,5,6,47,147,131,63,55,278
Snohomish14451503,65,47,5,7,16,69,213,203,97,112,416
Snohomish14451508,31,37,3,11,6,27,150,99,47,68,249
Snohomish14451536,54,77,9,9,10,77,286,234,105,131,520
Snohomish14451625,44,56,2,10,3,58,198,180,73,100,378
Snohomish14451649,39,39,0,18,5,74,196,251,97,78,447
Snohomish14451663,35,55,3,8,2,73,199,242,86,90,441
Snohomish14451664,46,58,4,2,10,86,208,226,102,104,434
Snohomish14451671,31,49,4,1,6,43,172,132,54,80,304
Snohomish14451672,39,61,2,8,3,48,241,168,61,100,409
Snohomish14451673,57,62,4,13,7,72,244,235,96,119,479
Snohomish14451674,64,43,1,2,5,67,213,172,75,107,385
Snohomish14451675,91,70,7,14,12,88,357,271,121,161,628
Snohomish14451709,24,36,6,9,4,50,143,146,69,60,289
Snohomish14451716,39,51,3,8,8,45,202,159,64,90,361
Snohomish14451717,48,61,3,16,8,75,314,241,102,109,555
Snohomish14451718,36,58,7,11,6,54,250,193,78,94,443
Snohomish14451719,63,54,1,22,7,84,400,375,114,117,775
Snohomish14451720,60,51,4,14,5,66,225,212,89,111,437
Snohomish14451721,61,48,5,15,12,91,260,235,123,109,495
Snohomish14451722,43,78,2,15,4,41,252,160,62,121,412
Snohomish14451723,22,48,3,11,7,50,181,185,71,70,366
Snohomish14451724,48,57,5,10,2,36,190,165,53,105,355
Snohomish14451725,13,15,1,6,2,24,65,75,33,28,140
Snohomish14451726,19,25,3,2,3,31,158,101,39,44,259
Snohomish14451727,27,28,3,4,1,30,145,109,38,55,254
Snohomish14451757,35,66,1,11,3,78,227,242,93,101,469
Snohomish14454012,56,69,3,17,26,62,339,259,108,125,598
Snohomish14454017,39,29,5,5,13,54,146,173,77,68,319
Snohomish14454018,0,0,0,2,0,12,4,21,14,0,25
Snohomish14454024,27,50,6,6,14,68,165,174,94,77,339
Snohomish14454029,58,71,11,9,5,79,277,257,104,129,534
Snohomish14454045,66,59,5,10,8,116,280,313,139,125,593
Snohomish14454046,38,35,1,7,9,70,160,162,87,73,322
Snohomish14454052,50,63,6,13,12,51,247,212,82,113,459
Snohomish14454059,40,52,4,7,9,69,247,244,89,92,491
Snohomish14454066,55,48,1,10,6,75,186,216,92,103,402
Snohomish14454067,39,40,1,3,7,46,150,153,57,79,303
Snohomish14454072,33,18,3,4,3,38,114,123,48,51,237
Snohomish14454075,89,76,6,15,7,107,389,321,135,165,710
Snohomish14454291,47,42,5,10,8,66,197,206,89,89,403
Snohomish14454300,46,41,6,4,7,73,166,217,90,87,383
Snohomish14454311,0,0,0,0,0,0,8,11,0,0,19
Snohomish14454312,66,78,4,9,17,111,299,294,141,144,593
Snohomish14454313,64,48,9,8,9,73,252,213,99,112,465
Snohomish14454315,52,42,3,5,9,59,223,150,76,94,373
Snohomish14454336,54,40,3,10,9,44,243,168,66,94,411
Snohomish14454339,74,77,5,4,15,78,333,238,102,151,571
Snohomish14454345,52,49,1,10,5,65,212,234,81,101,446
Snohomish14454358,8,5,0,4,1,9,31,32,14,13,63
Snohomish14454364,56,39,1,6,8,43,223,136,58,95,359
Snohomish14454366,37,21,3,10,2,28,141,94,43,58,235
Snohomish14454458,38,45,3,8,14,45,203,120,70,83,323
Snohomish14454464,61,56,2,13,5,54,240,212,74,117,452
Snohomish14454477,57,47,3,12,14,42,183,158,71,104,341
Snohomish14454478,44,41,3,9,4,56,201,182,72,85,383
Snohomish14454480,75,37,1,15,7,65,299,184,88,112,483
Snohomish14454482,23,37,2,6,4,38,131,134,50,60,265
Snohomish14454485,27,18,1,2,5,21,90,75,29,45,165
Snohomish14454490,67,93,12,9,5,101,382,338,127,160,720
Snohomish14454493,42,36,1,6,7,53,166,116,67,78,282
Snohomish14454530,53,55,6,5,1,96,217,241,108,108,458
Snohomish14454531,72,45,5,16,7,76,280,203,104,117,483
Snohomish14454532,15,19,3,8,1,38,69,96,50,34,165
Snohomish14454549,51,38,3,14,14,95,185,239,126,89,424
Snohomish14454554,64,74,3,3,6,61,395,236,73,138,631
Snohomish14454580,55,67,4,8,6,67,204,180,85,122,384
Snohomish14454585,2,4,0,0,0,0,23,15,0,6,38
Snohomish14454588,47,56,3,17,6,50,274,184,76,103,458
Snohomish14454634,35,58,2,12,4,103,249,232,121,93,481
Snohomish14454648,32,25,2,6,10,35,129,121,53,57,250
Snohomish14454706,59,91,10,8,14,62,437,274,94,150,711
Snohomish20134083,109,104,5,9,9,62,548,205,85,213,753
Snohomish20134196,84,68,1,9,7,67,372,177,84,152,549
Snohomish20134316,43,38,3,2,5,32,201,96,42,81,297
Snohomish20134690,18,25,2,5,2,16,120,53,25,43,173
Snohomish20141090,71,71,0,8,5,33,346,88,46,142,434
Snohomish20141091,82,77,1,7,7,32,440,149,47,159,589
Snohomish20141092,62,60,3,14,1,41,329,107,59,122,436
Snohomish20141093,84,59,0,14,7,34,326,128,55,143,454
Snohomish20141094,53,59,0,8,5,40,275,103,53,112,378
Snohomish20141138,59,91,1,7,2,41,347,104,51,150,451
Snohomish20141139,70,67,3,9,3,30,294,105,45,137,399
Snohomish20141140,98,91,1,12,6,50,419,137,69,189,556
Snohomish20141141,76,79,2,18,12,48,386,149,80,155,535
Snohomish20141142,66,67,2,4,2,32,265,110,40,133,375
Snohomish20141179,74,77,8,16,6,46,333,133,76,151,466
Snohomish20141180,63,35,1,6,6,52,259,124,65,98,383
Snohomish20141181,103,80,3,13,12,63,475,202,91,183,677
Snohomish20141189,115,109,2,10,9,34,524,121,55,224,645
Snohomish20141190,67,73,5,4,10,45,295,123,64,140,418
Snohomish20141191,60,75,4,18,6,53,358,131,81,135,489
Snohomish20141276,74,55,0,8,27,37,340,124,72,129,464
Snohomish20141277,73,54,5,11,7,72,349,201,95,127,550
Snohomish20141343,58,41,3,9,11,34,218,91,57,99,309
Snohomish20141344,57,56,2,7,2,52,270,172,63,113,442
Snohomish20141432,57,51,1,9,3,31,234,100,44,108,334
Snohomish20141614,46,66,3,11,7,44,244,122,65,112,366
Snohomish20141630,63,95,1,2,3,29,391,79,35,158,470
Snohomish20144065,57,88,3,10,6,40,382,144,59,145,526
Snohomish20144078,61,59,4,11,14,40,341,145,69,120,486
Snohomish20144085,86,90,0,12,9,47,502,172,68,176,674
Snohomish20144089,0,0,0,0,0,0,8,4,0,0,12
Snohomish20144136,70,84,2,13,7,48,411,189,70,154,600
Snohomish20144146,74,54,3,12,7,39,270,114,61,128,384
Snohomish20144177,84,69,9,14,3,59,352,160,85,153,512
Snohomish20144212,86,70,3,16,9,61,477,184,89,156,661
Snohomish20144213,93,112,2,14,12,57,465,218,85,205,683
Snohomish20144281,45,32,3,3,10,28,254,118,44,77,372
Snohomish20144284,57,62,1,3,4,32,311,126,40,119,437
Snohomish20144324,61,96,7,18,1,43,343,148,69,157,491
Snohomish20144446,90,94,4,12,10,65,381,190,91,184,571
Snohomish20144596,100,40,7,15,27,72,225,159,121,140,384
Snohomish20144705,46,64,2,11,6,36,357,172,55,110,529
Snohomish21011199,34,37,2,6,6,37,120,132,51,71,252
Snohomish21011200,52,53,11,15,9,67,156,196,102,105,352
Snohomish21011509,41,41,2,17,12,75,169,198,106,82,367
Snohomish21011641,74,60,4,23,28,100,262,284,155,134,546
Snohomish21011669,52,61,8,14,13,101,228,347,136,113,575
Snohomish21011711,35,31,1,7,3,76,164,225,87,66,389
Snohomish21011712,35,38,4,3,3,49,147,147,59,73,294
Snohomish21014002,22,9,6,8,3,28,73,100,45,31,173
Snohomish21014004,67,58,11,21,18,113,243,305,163,125,548
Snohomish21014022,53,36,6,7,14,85,184,244,112,89,428
Snohomish21014025,47,52,4,3,8,53,148,147,68,99,295
Snohomish21014030,19,15,1,3,4,29,44,65,37,34,109
Snohomish21014037,25,28,3,5,1,58,128,200,67,53,328
Snohomish21014061,21,44,6,12,5,81,134,251,104,65,385
Snohomish21014073,70,68,12,12,7,103,272,299,134,138,571
Snohomish21014087,55,85,3,11,5,132,331,344,151,140,675
Snohomish21014296,36,47,3,5,1,78,116,218,87,83,334
Snohomish21014319,43,26,3,9,5,54,161,162,71,69,323
Snohomish21014323,65,65,4,13,15,98,218,285,130,130,503
Snohomish21014332,64,53,12,29,22,86,188,263,149,117,451
Snohomish21014352,32,38,3,6,8,69,129,204,86,70,333
Snohomish21014457,42,36,4,6,8,69,139,190,87,78,329
Snohomish21014483,50,50,1,10,24,119,238,307,154,100,545
Snohomish21014502,71,62,1,12,5,80,210,239,98,133,449
Snohomish21014545,20,29,2,8,6,81,123,226,97,49,349
Snohomish21014638,52,51,2,7,8,84,187,228,101,103,415
Snohomish21014682,29,29,2,11,7,62,119,188,82,58,307
Snohomish21014700,44,44,5,21,6,98,189,266,130,88,455
Snohomish21014708,23,37,6,6,8,69,128,197,89,60,325
Snohomish21014714,67,59,10,15,15,121,256,321,161,126,577
Snohomish22121192,89,64,5,10,23,83,356,218,121,153,574
Snohomish22121193,134,66,1,8,6,91,493,218,106,200,711
Snohomish22121194,54,52,4,14,12,48,256,159,78,106,415
Snohomish22121259,39,75,0,4,9,44,265,155,57,114,420
Snohomish22121260,73,55,6,3,5,47,289,137,61,128,426
Snohomish22121262,48,43,0,9,9,49,215,115,67,91,330
Snohomish22121263,88,65,0,12,12,110,404,244,134,153,648
Snohomish22121306,57,26,2,8,18,51,219,133,79,83,352
Snohomish22121307,62,62,3,4,18,62,249,163,87,124,412
Snohomish22121355,77,63,1,3,4,68,286,174,76,140,460
Snohomish22121378,69,72,5,13,10,54,329,138,82,141,467
Snohomish22121379,137,74,4,15,21,82,472,212,122,211,684
Snohomish22121380,80,43,0,7,12,60,311,148,79,123,459
Snohomish22121381,93,67,2,6,18,88,332,192,114,160,524
Snohomish22121382,115,62,4,5,14,63,412,194,86,177,606
Snohomish22121383,112,71,1,12,20,92,422,215,125,183,637
Snohomish22121400,76,50,1,14,8,66,318,238,89,126,556
Snohomish22121405,40,36,2,0,2,32,222,105,36,76,327
Snohomish22121406,40,47,3,14,4,47,253,176,68,87,429
Snohomish22121407,92,76,5,7,5,55,382,208,72,168,590
Snohomish22121448,15,35,1,2,4,20,155,80,27,50,235
Snohomish22121474,83,54,7,18,22,72,398,229,119,137,627
Snohomish22121475,54,61,3,6,13,52,306,165,74,115,471
Snohomish22121491,56,52,3,3,4,40,210,121,50,108,331
Snohomish22121615,83,55,2,8,6,53,254,150,69,138,404
Snohomish22121616,14,18,0,0,0,0,62,36,0,32,98
Snohomish22121621,50,55,3,9,6,40,242,164,58,105,406
Snohomish22121622,52,58,2,6,3,53,214,161,64,110,375
Snohomish22121624,0,0,0,0,0,0,12,9,0,0,21
Snohomish22121631,98,75,6,8,21,59,363,165,94,173,528
Snohomish22121632,21,36,0,0,0,0,147,86,0,57,233
Snohomish22121633,81,76,3,13,13,54,380,169,83,157,549
Snohomish22121655,74,64,3,12,7,39,303,123,61,138,426
Snohomish22121697,27,65,3,12,1,30,216,105,46,92,321
Snohomish22121704,42,24,2,6,3,35,177,91,46,66,268
Snohomish22124068,7,20,0,0,0,0,72,33,0,27,105
Snohomish22124100,83,40,0,2,7,43,233,117,52,123,350
Snohomish22124185,76,72,1,6,1,62,317,154,70,148,471
Snohomish22124274,67,66,1,14,11,68,323,189,94,133,512
Snohomish22124337,70,56,5,11,16,77,283,187,109,126,470
Snohomish22124486,46,39,2,6,2,42,209,133,52,85,342
Snohomish22124589,16,12,0,0,0,0,55,30,0,28,85
Snohomish22124773,14,21,0,4,2,14,90,33,20,35,123
Snohomish22131422,73,50,5,19,6,46,258,159,76,123,417
Snohomish22131538,60,40,2,3,5,30,213,67,40,100,280
Snohomish22134040,80,63,2,6,7,50,320,140,65,143,460
Snohomish22134063,68,67,1,4,7,44,344,208,56,135,552
Snohomish22134076,46,66,1,4,5,35,337,120,45,112,457
Snohomish22134079,90,64,1,8,5,33,378,115,47,154,493
Snohomish22134080,86,64,0,13,13,45,346,142,71,150,488
Snohomish22134082,72,53,1,9,4,87,283,179,101,125,462
Snohomish22134084,73,51,3,9,4,49,319,158,65,124,477
Snohomish22134088,64,62,3,18,7,56,301,175,84,126,476
Snohomish22134150,83,83,3,10,8,65,378,184,86,166,562
Snohomish22134152,41,71,5,11,3,33,287,119,52,112,406
Snohomish22134183,81,70,0,12,10,59,446,210,81,151,656
Snohomish22134195,78,62,2,14,6,51,334,146,73,140,480
Snohomish22134265,77,67,2,4,3,31,324,125,40,144,449
Snohomish22134268,107,106,0,17,12,71,436,226,100,213,662
Snohomish22134282,71,62,3,12,5,47,298,129,67,133,427
Snohomish22134286,75,78,13,19,11,69,313,199,112,153,512
Snohomish22134314,55,44,4,8,6,32,217,120,50,99,337
Snohomish22134320,77,95,4,5,10,77,345,182,96,172,527
Snohomish22134356,70,85,1,8,4,45,352,134,58,155,486
Snohomish22134359,71,59,4,7,6,47,259,123,64,130,382
Snohomish22134362,72,54,3,11,13,38,299,140,65,126,439
Snohomish22134368,88,84,3,10,11,43,460,175,67,172,635
Snohomish22134373,71,74,3,10,14,57,322,153,84,145,475
Snohomish22134427,66,83,0,5,11,47,312,158,63,149,470
Snohomish22134434,87,81,2,12,8,54,405,156,76,168,561
Snohomish22134456,102,87,2,9,10,63,378,185,84,189,563
Snohomish22134459,43,61,3,6,4,31,331,112,44,104,443
Snohomish22134460,61,44,0,1,4,32,293,105,37,105,398
Snohomish22134463,63,42,1,4,7,35,303,132,47,105,435
Snohomish22134489,32,35,5,1,7,40,177,98,53,67,275
Snohomish22134492,29,39,1,6,1,32,201,121,40,68,322
Snohomish22134497,88,84,4,7,1,42,415,136,54,172,551
Snohomish22134501,56,36,4,4,8,48,236,123,64,92,359
Snohomish22134520,55,68,0,3,3,43,293,136,49,123,429
Snohomish22134642,70,64,0,8,6,42,309,118,56,134,427
Snohomish22134688,39,62,1,4,0,37,252,132,42,101,384
Snohomish22134692,43,78,1,4,2,23,415,136,30,121,551
Snohomish22134699,61,45,1,15,8,35,274,112,59,106,386
Snohomish22134758,37,40,0,5,2,19,203,52,26,77,255
Snohomish22134764,49,40,0,7,1,35,215,101,43,89,316
Snohomish22134765,53,33,2,11,3,33,237,121,49,86,358
Snohomish22134772,46,48,2,13,2,36,282,106,53,94,388
Snohomish22144081,71,69,3,9,12,80,368,230,104,140,598
Snohomish22144131,59,66,2,4,3,63,285,190,72,125,475
Snohomish22144166,58,51,6,9,11,63,288,159,89,109,447
Snohomish22144209,54,46,2,13,5,83,278,211,103,100,489
Snohomish22144279,83,76,6,14,20,86,423,250,126,159,673
Snohomish22144280,55,35,2,17,8,53,218,143,80,90,361
Snohomish22144297,41,53,5,8,5,40,231,122,58,94,353
Snohomish22144331,51,47,4,8,5,44,229,111,61,98,340
Snohomish22144415,46,78,1,8,1,42,359,153,52,124,512
Snohomish22144455,93,87,3,8,8,59,368,166,78,180,534
Snohomish22144476,75,79,4,7,11,66,406,202,88,154,608
Snohomish22144481,35,38,2,11,13,35,255,120,61,73,375
Snohomish22144527,61,58,1,11,4,45,378,151,61,119,529
Snohomish22144546,65,64,8,13,9,45,357,171,75,129,528
Snohomish22144556,13,19,0,0,0,0,88,41,0,32,129
Snohomish22144578,69,63,6,18,7,56,307,165,87,132,472
Snohomish22144689,85,62,0,8,5,70,361,161,83,147,522
Snohomish22144707,58,54,3,13,5,47,354,197,68,112,551
Snohomish23231115,71,57,3,6,1,24,257,63,34,128,320
Snohomish23231116,73,52,1,8,4,35,213,102,48,125,315
Snohomish23231117,61,65,4,9,3,51,275,158,67,126,433
Snohomish23231118,86,57,2,3,2,36,296,114,43,143,410
Snohomish23231119,44,66,7,1,4,22,259,90,34,110,349
Snohomish23231120,87,63,4,6,2,35,313,136,47,150,449
Snohomish23231121,93,68,1,21,7,50,339,158,79,161,497
Snohomish23231122,55,62,0,5,8,23,219,102,36,117,321
Snohomish23231123,96,58,3,4,8,57,317,142,72,154,459
Snohomish23231124,55,39,3,4,1,34,184,79,42,94,263
Snohomish23231125,66,83,2,4,5,45,354,147,56,149,501
Snohomish23231168,48,57,3,8,6,36,234,116,53,105,350
Snohomish23231186,67,62,2,12,5,49,256,130,68,129,386
Snohomish23231201,109,77,6,10,7,79,370,187,102,186,557
Snohomish23231202,63,66,8,5,7,37,273,127,57,129,400
Snohomish23231203,82,81,5,10,4,44,345,155,63,163,500
Snohomish23231204,54,68,1,8,6,33,250,94,48,122,344
Snohomish23231205,87,75,4,9,8,32,330,106,53,162,436
Snohomish23231206,71,81,1,0,4,34,312,109,39,152,421
Snohomish23231207,50,38,2,12,6,33,200,95,53,88,295
Snohomish23231208,92,103,5,7,8,87,450,210,107,195,660
Snohomish23231210,69,77,3,11,7,65,304,192,86,146,496
Snohomish23231419,78,76,3,10,6,49,307,162,68,154,469
Snohomish23231420,59,38,2,7,6,47,244,120,62,97,364
Snohomish23231421,71,52,0,7,4,50,264,108,61,123,372
Snohomish23231423,61,92,3,14,11,47,295,142,75,153,437
Snohomish23231424,59,29,3,6,4,29,209,99,42,88,308
Snohomish23231462,0,0,0,0,0,0,0,0,0,0,0
Snohomish23231516,77,69,4,5,2,62,382,180,73,146,562
Snohomish23231626,93,95,4,6,12,69,375,172,91,188,547
Snohomish23231627,83,57,6,8,10,55,373,147,79,140,520
Snohomish23234077,45,53,3,3,5,43,253,116,54,98,369
Snohomish23234175,63,82,8,8,12,35,336,148,63,145,484
Snohomish23234184,105,87,2,21,8,50,416,166,81,192,582
Snohomish23234444,19,7,2,2,3,9,57,35,16,26,92
Snohomish23234461,67,59,3,7,12,51,274,148,73,126,422
Snohomish23234539,62,71,1,9,6,48,319,148,64,133,467
Snohomish23234550,26,17,2,2,0,11,93,37,15,43,130
Snohomish23234755,45,55,0,13,5,22,240,80,40,100,320
Snohomish23234761,35,43,2,8,5,34,259,106,49,78,365
Snohomish23241095,38,55,0,4,6,30,200,102,40,93,302
Snohomish23241096,76,65,1,12,11,47,394,119,71,141,513
Snohomish23241097,51,53,0,11,4,39,229,104,54,104,333
Snohomish23241137,120,100,5,12,15,83,509,172,115,220,681
Snohomish23244749,0,0,0,0,0,0,0,0,0,0,0
Snohomish23811047,37,48,3,5,0,57,138,170,65,85,308
Snohomish23811048,17,44,4,4,4,29,107,126,41,61,233
Snohomish23811128,35,91,2,10,8,50,230,179,70,126,409
Snohomish23811129,58,56,1,7,4,72,205,196,84,114,401
Snohomish23811261,51,49,4,12,5,80,224,239,101,100,463
Snohomish23811299,20,34,1,6,0,33,124,110,40,54,234
Snohomish23811342,67,58,4,14,11,111,250,271,140,125,521
Snohomish23811350,42,27,3,6,3,58,116,152,70,69,268
Snohomish23811351,58,64,7,8,4,59,250,195,78,122,445
Snohomish23811429,42,55,5,5,4,62,220,192,76,97,412
Snohomish23811430,43,67,5,7,8,57,183,180,77,110,363
Snohomish23811465,48,62,2,2,3,58,247,249,65,110,496
Snohomish23811467,70,53,3,18,4,71,216,212,96,123,428
Snohomish23811504,50,59,5,9,8,82,257,220,104,109,477
Snohomish23811544,102,54,7,8,4,88,268,236,107,156,504
Snohomish23811571,74,62,4,13,9,97,272,284,123,136,556
Snohomish23811572,42,36,3,7,4,58,127,160,72,78,287
Snohomish23811650,31,47,1,4,0,40,169,134,45,78,303
Snohomish23811651,50,57,3,10,5,51,313,272,69,107,585
Snohomish23811679,47,45,2,9,8,55,149,194,74,92,343
Snohomish23811728,48,65,9,13,5,85,223,243,112,113,466
Snohomish23811729,32,41,1,11,3,55,165,153,70,73,318
Snohomish23811730,52,36,3,4,6,57,142,156,70,88,298
Snohomish23811731,38,56,3,8,3,46,172,167,60,94,339
Snohomish23811732,62,45,9,7,8,57,182,171,81,107,353
Snohomish23811733,47,40,2,7,10,60,142,170,79,87,312
Snohomish23811734,34,41,1,3,0,43,170,139,47,75,309
Snohomish23811735,52,45,4,9,1,72,187,208,86,97,395
Snohomish23811736,37,46,2,10,2,83,188,252,97,83,440
Snohomish23811739,65,72,5,11,3,130,247,327,149,137,574
Snohomish23811740,65,47,3,14,6,67,231,200,90,112,431
Snohomish23811741,61,47,7,14,6,65,208,184,92,108,392
Snohomish23811742,58,39,6,6,6,68,158,205,86,97,363
Snohomish23811743,50,47,3,4,7,77,239,231,91,97,470
Snohomish23811744,25,23,2,7,5,32,130,103,46,48,233
Snohomish23814167,65,51,1,14,10,71,194,196,96,116,390
Snohomish23814325,0,0,0,0,0,0,0,0,0,0,0
Snohomish23814335,41,56,5,9,2,71,156,198,87,97,354
Snohomish23814363,32,65,6,12,10,115,181,351,143,97,532
Snohomish23814488,48,38,2,11,6,93,188,210,112,86,398
Snohomish23821214,79,56,1,2,18,46,313,132,67,135,445
Snohomish23821215,78,52,2,7,6,24,289,92,39,130,381
Snohomish23821216,53,67,0,0,0,0,226,102,0,120,328
Snohomish23821217,57,39,0,2,9,56,252,143,67,96,395
Snohomish23821218,37,71,2,9,2,30,219,114,43,108,333
Snohomish23821219,68,60,6,4,6,53,251,183,69,128,434
Snohomish23821220,65,57,3,13,16,45,315,152,77,122,467
Snohomish23821221,66,65,1,12,7,30,290,114,50,131,404
Snohomish23821222,39,85,2,5,2,47,274,144,56,124,418
Snohomish23821223,76,65,2,5,2,35,299,129,44,141,428
Snohomish23821224,55,76,3,5,3,58,267,134,69,131,401
Snohomish23821225,46,72,1,6,5,44,234,119,56,118,353
Snohomish23821226,31,59,1,5,1,27,169,94,34,90,263
Snohomish23821227,90,138,1,14,7,73,435,181,95,228,616
Snohomish23821228,82,81,3,5,8,31,325,122,47,163,447
Snohomish23821229,88,75,3,5,7,63,309,160,78,163,469
Snohomish23821230,75,83,6,12,8,51,351,184,77,158,535
Snohomish23821231,72,64,1,12,9,33,296,146,55,136,442
Snohomish23821232,66,63,4,11,3,59,237,149,77,129,386
Snohomish23821233,71,90,0,6,2,36,345,142,44,161,487
Snohomish23821234,88,86,3,5,10,60,338,190,78,174,528
Snohomish23821235,62,71,3,6,6,43,282,143,58,133,425
Snohomish23821236,42,51,2,13,0,45,194,124,60,93,318
Snohomish23821237,43,31,0,2,2,47,175,126,51,74,301
Snohomish23821238,36,63,3,3,3,33,203,125,42,99,328
Snohomish23821239,66,67,3,5,5,48,279,175,61,133,454
Snohomish23821240,74,66,2,9,4,86,312,214,101,140,526
Snohomish23821241,36,51,5,10,2,44,222,140,61,87,362
Snohomish23821242,42,75,2,4,2,50,258,148,58,117,406
Snohomish23821243,50,66,2,12,4,51,255,144,69,116,399
Snohomish23821244,15,20,0,0,4,19,65,57,23,35,122
Snohomish23821245,41,54,5,9,3,40,242,186,57,95,428
Snohomish23821246,28,54,0,0,4,26,157,92,30,82,249
Snohomish23821247,71,30,1,2,12,63,160,127,78,101,287
Snohomish23821248,52,48,4,3,4,42,214,139,53,100,353
Snohomish23821249,30,36,0,0,4,49,151,148,53,66,299
Snohomish23821250,49,34,2,8,6,33,204,133,49,83,337
Snohomish23821251,42,53,4,8,1,49,240,151,62,95,391
Snohomish23821252,42,56,6,6,4,40,214,129,56,98,343
Snohomish23821253,62,35,3,7,9,60,263,160,79,97,423
Snohomish23821254,52,68,2,7,4,44,252,149,57,120,401
Snohomish23821255,54,38,3,7,5,41,209,120,56,92,329
Snohomish23821256,77,47,2,8,6,54,266,151,70,124,417
Snohomish23821257,57,30,4,11,12,46,237,137,73,87,374
Snohomish23821258,49,51,2,5,2,32,209,93,41,100,302
Snohomish23821287,69,71,2,1,7,35,292,95,45,140,387
Snohomish23821288,56,70,1,7,8,52,277,123,68,126,400
Snohomish23821289,53,85,2,9,9,59,285,167,79,138,452
Snohomish23821290,62,65,4,12,5,55,295,189,76,127,484
Snohomish23821327,62,56,0,7,11,76,231,192,94,118,423
Snohomish23821328,68,54,5,2,5,35,290,113,47,122,403
Snohomish23821346,46,67,2,11,8,48,318,149,69,113,467
Snohomish23821365,51,44,4,4,7,68,299,192,83,95,491
Snohomish23821394,76,79,7,7,0,44,283,146,58,155,429
Snohomish23821395,51,45,1,2,0,13,175,56,16,96,231
Snohomish23821396,74,73,8,15,12,92,354,253,127,147,607
Snohomish23821397,57,58,0,8,1,32,223,94,41,115,317
Snohomish23821398,2,12,0,2,2,23,33,52,27,14,85
Snohomish23821399,47,86,4,18,6,58,300,212,86,133,512
Snohomish23821401,60,55,4,9,5,51,267,137,69,115,404
Snohomish23821402,89,82,5,6,4,48,289,122,63,171,411
Snohomish23821403,6,9,0,0,0,0,41,35,0,15,76
Snohomish23821404,72,58,3,6,12,43,305,164,64,130,469
Snohomish23821408,90,65,3,10,11,113,357,252,137,155,609
Snohomish23821409,0,0,0,0,0,0,2,2,0,0,4
Snohomish23821410,37,52,1,9,1,29,194,112,40,89,306
Snohomish23821411,47,41,1,1,2,38,183,104,42,88,287
Snohomish23821412,39,28,4,7,2,40,181,107,53,67,288
Snohomish23821413,71,66,2,3,10,74,266,197,89,137,463
Snohomish23821414,41,37,3,6,1,25,165,92,35,78,257
Snohomish23821440,84,62,0,6,6,89,259,250,101,146,509
Snohomish23821449,38,33,8,1,7,37,193,138,53,71,331
Snohomish23821450,32,51,2,9,2,44,238,144,57,83,382
Snohomish23821451,53,60,5,13,11,69,198,151,98,113,349
Snohomish23821452,46,75,1,11,7,34,257,120,53,121,377
Snohomish23821453,21,28,3,0,0,13,110,64,16,49,174
Snohomish23821510,37,46,2,2,2,42,205,121,48,83,326
Snohomish23821558,30,34,0,3,0,23,151,66,26,64,217
Snohomish23821617,49,51,3,2,6,63,219,134,74,100,353
Snohomish23821618,45,53,4,5,4,52,204,141,65,98,345
Snohomish23821619,41,31,0,9,0,42,139,123,51,72,262
Snohomish23821620,22,32,0,6,2,24,135,80,32,54,215
Snohomish23821623,54,57,1,3,8,62,282,170,74,111,452
Snohomish23821645,72,30,4,2,11,36,200,98,53,102,298
Snohomish23821662,53,24,0,5,8,58,228,163,71,77,391
Snohomish23821695,73,46,6,4,2,40,211,111,52,119,322
Snohomish23821696,31,46,5,9,2,48,238,150,64,77,388
Snohomish23824098,42,39,0,0,8,38,159,111,46,81,270
Snohomish23824169,27,25,3,11,0,54,124,167,68,52,291
Snohomish23824267,4,7,0,0,0,0,17,31,0,11,48
Snohomish23824269,51,58,5,9,10,113,272,339,137,109,611
Snohomish23824441,47,49,1,7,2,67,204,187,77,96,391
Snohomish23824445,37,20,1,9,15,63,142,195,88,57,337
Snohomish23824561,16,26,1,3,5,16,134,59,25,42,193
Snohomish23824593,0,0,0,0,0,0,0,0,0,0,0
Snohomish23824752,7,10,0,0,6,11,54,37,17,17,91
Snohomish23854756,11,3,0,0,0,0,36,26,0,14,62
Snohomish23911049,56,47,6,9,8,73,194,209,96,103,403
Snohomish23911050,20,51,0,6,4,55,150,161,65,71,311
Snohomish23911051,57,43,4,7,1,67,162,185,79,100,347
Snohomish23911130,91,69,14,12,6,116,263,324,148,160,587
Snohomish23911386,77,56,6,21,12,111,263,324,150,133,587
Snohomish23911468,51,57,2,12,12,82,213,229,108,108,442
Snohomish23911498,57,66,5,17,8,66,205,230,96,123,435
Snohomish23911499,57,55,12,16,8,108,220,314,144,112,534
Snohomish23911518,62,36,7,6,11,108,176,246,132,98,422
Snohomish23911569,70,60,4,14,6,89,251,290,113,130,541
Snohomish23911570,52,79,5,13,5,117,206,316,140,131,522
Snohomish23911574,21,34,3,3,8,51,136,154,65,55,290
Snohomish23911636,26,35,4,7,4,52,123,196,67,61,319
Snohomish23911643,44,69,5,12,9,120,246,388,146,113,634
Snohomish23911661,38,42,1,8,2,76,160,229,87,80,389
Snohomish23911680,0,0,0,0,0,0,3,2,0,0,5
Snohomish23911686,20,33,2,2,0,38,95,114,42,53,209
Snohomish23911687,27,40,7,10,5,72,149,216,94,67,365
Snohomish23911737,61,77,2,8,7,87,278,280,104,138,558
Snohomish23911738,34,62,3,9,5,59,155,194,76,96,349
Snohomish23911745,37,46,1,7,8,57,181,176,73,83,357
Snohomish23911746,28,58,4,4,6,62,171,195,76,86,366
Snohomish23911747,60,86,3,13,6,102,264,294,124,146,558
Snohomish23911751,0,0,0,0,0,0,3,7,0,0,10
Snohomish23911768,29,18,5,9,0,28,110,110,42,47,220
Snohomish23911769,36,48,3,4,3,47,156,146,57,84,302
Snohomish23911770,25,32,3,8,7,36,108,137,54,57,245
Snohomish23914020,20,25,3,5,3,43,92,142,54,45,234
Snohomish23914023,31,49,3,13,0,66,151,219,82,80,370
Snohomish23914151,13,6,1,4,4,12,31,36,21,19,67
Snohomish23914360,11,20,2,4,4,36,68,98,46,31,166
Snohomish24411428,54,60,5,23,13,89,267,262,130,114,529
Snohomish24411466,43,59,5,16,7,71,250,225,99,102,475
Snohomish24411494,35,34,3,21,12,63,177,202,99,69,379
Snohomish24411540,60,68,10,14,7,89,271,288,120,128,559
Snohomish24411541,68,92,5,13,8,102,268,298,128,160,566
Snohomish24411542,35,43,3,5,1,46,175,181,55,78,356
Snohomish24411543,50,30,10,4,6,60,153,177,80,80,330
Snohomish24411628,64,70,3,19,12,96,262,303,130,134,565
Snohomish24411676,63,73,6,10,6,92,325,257,114,136,582
Snohomish24411677,49,53,5,21,8,84,304,266,118,102,570
Snohomish24411678,43,65,3,12,3,81,237,233,99,108,470
Snohomish24411701,37,52,3,8,3,83,198,240,97,89,438
Snohomish24411748,38,29,0,13,6,50,157,151,69,67,308
Snohomish24411766,42,68,6,12,5,88,269,246,111,110,515
Snohomish24411767,8,16,1,2,3,27,88,125,33,24,213
Snohomish24424001,3,3,0,5,0,13,17,36,18,6,53
Snohomish24424019,2,4,0,0,0,0,13,27,0,6,40
Snohomish24424126,52,48,0,7,4,35,200,125,46,100,325
Snohomish24424528,26,34,0,8,4,39,173,155,51,60,328
Snohomish24444074,70,55,3,14,3,47,268,166,67,125,434
Snohomish24444285,58,58,3,4,4,63,307,184,74,116,491
Snohomish24444294,35,37,1,4,3,28,114,105,36,72,219
Snohomish24454086,57,47,3,5,5,70,236,187,83,104,423
Snohomish24454172,34,39,5,3,8,54,163,144,70,73,307
Snohomish24454197,67,58,5,6,3,60,267,167,74,125,434
Snohomish24454198,20,19,3,6,0,37,106,139,46,39,245
Snohomish24454295,99,66,6,18,9,100,417,307,133,165,724
Snohomish24454341,58,47,5,15,8,64,253,198,92,105,451
Snohomish24454591,0,0,0,0,0,0,0,0,0,0,0
Snohomish24454698,0,0,0,0,0,0,3,4,0,0,7
Snohomish72131101,80,42,2,6,30,51,297,140,89,122,437
Snohomish72131102,103,39,3,9,20,71,307,159,103,142,466
Snohomish72131103,121,72,2,10,20,60,386,166,92,193,552
Snohomish72131104,115,64,4,6,16,49,303,101,75,179,404
Snohomish72131105,64,39,1,6,11,35,199,82,53,103,281
Snohomish72131107,130,92,3,9,17,50,399,144,79,222,543
Snohomish72131108,114,66,0,13,18,71,415,207,102,180,622
Snohomish72131109,93,41,2,1,14,41,212,90,58,134,302
Snohomish72131110,114,48,2,16,19,55,331,161,92,162,492
Snohomish72131111,131,71,5,9,13,64,415,163,91,202,578
Snohomish72131127,89,50,3,5,12,36,301,99,56,139,400
Snohomish72131147,96,45,3,4,10,46,286,125,63,141,411
Snohomish72131148,85,55,2,13,25,69,303,200,109,140,503
Snohomish72131155,101,55,3,9,21,40,313,135,73,156,448
Snohomish72131156,103,66,3,7,13,37,339,117,60,169,456
Snohomish72131157,63,66,3,10,4,53,306,112,70,129,418
Snohomish72131158,94,66,3,12,13,58,384,160,86,160,544
Snohomish72131159,69,106,2,6,13,54,410,129,75,175,539
Snohomish72131160,72,68,9,8,8,53,312,121,78,140,433
Snohomish72131161,85,60,0,2,13,52,319,129,67,145,448
Snohomish72131162,67,40,2,3,19,39,262,121,63,107,383
Snohomish72131163,85,44,4,5,21,49,284,116,79,129,400
Snohomish72131164,80,64,0,6,15,52,308,138,73,144,446
Snohomish72131390,103,70,6,10,14,104,332,215,134,173,547
Snohomish72131391,81,32,2,9,7,28,236,95,46,113,331
Snohomish72131392,65,44,3,7,7,39,240,113,56,109,353
Snohomish72131393,73,48,3,7,17,51,330,141,78,121,471
Snohomish72131447,113,58,2,11,33,68,344,175,114,171,519
Snohomish72131524,165,68,2,10,31,98,448,215,141,233,663
Snohomish72131565,84,60,1,3,9,57,287,134,70,144,421
Snohomish72131694,127,66,1,6,17,76,340,150,100,193,490
Snohomish73231106,140,71,2,17,20,66,376,180,105,211,556
Snohomish73231112,71,67,2,3,5,38,323,99,48,138,422
Snohomish73231113,64,51,2,9,9,36,279,102,56,115,381
Snohomish73231114,54,91,2,7,4,35,360,105,48,145,465
Snohomish73231132,95,81,2,15,4,31,412,120,52,176,532
Snohomish73231133,109,115,4,4,3,47,519,164,58,224,683
Snohomish73231153,78,50,1,4,3,19,274,91,27,128,365
Snohomish73231154,67,56,1,4,9,45,310,103,59,123,413
Snohomish73231173,102,35,5,10,25,85,338,193,125,137,531
Snohomish73231174,41,25,0,7,5,54,137,142,66,66,279
Snohomish73231389,64,31,0,4,7,27,210,65,38,95,275
Snohomish73231500,92,88,7,4,8,56,409,131,75,180,540
Snohomish73231511,64,53,1,7,7,37,246,79,52,117,325
Snohomish73231512,64,53,5,9,3,36,239,106,53,117,345
Snohomish73231513,93,85,7,1,14,55,415,149,77,178,564
Snohomish73231514,98,60,0,7,11,46,318,105,64,158,423
Snohomish73231523,57,35,1,9,10,45,237,115,65,92,352
Snohomish73231525,48,54,1,3,1,29,219,72,34,102,291
Snohomish73231562,78,72,3,11,10,33,312,99,57,150,411
Snohomish73231563,72,66,1,10,9,39,330,103,59,138,433
Snohomish73231564,56,53,0,8,8,33,303,85,49,109,388
Snohomish73231577,88,76,4,4,6,46,364,108,60,164,472
Snohomish73234099,98,66,5,9,12,40,408,140,66,164,548
Snohomish73234143,44,41,5,16,8,28,190,91,57,85,281
Snohomish73234149,69,42,3,3,8,44,284,131,58,111,415
Snohomish73234176,74,47,2,5,14,38,282,106,59,121,388
Snohomish73234182,58,64,2,8,5,40,269,107,55,122,376
Spokane3000,0,0,0,0,0,0,0,0,0,0,0
Spokane3100,0,0,6,10,5,76,270,237,97,0,507
Spokane3101,62,67,0,14,4,68,243,230,86,129,473
Spokane3102,58,54,2,10,6,62,169,168,80,112,337
Spokane3103,58,61,0,15,8,60,231,209,83,119,440
Spokane3104,65,90,3,18,2,74,288,313,97,155,601
Spokane3105,85,78,8,23,3,65,246,251,99,163,497
Spokane3106,63,83,4,17,4,97,254,256,122,146,510
Spokane3107,64,109,3,16,6,89,280,269,114,173,549
Spokane3108,44,63,6,7,7,63,193,204,83,107,397
Spokane3109,63,81,3,18,5,95,282,261,121,144,543
Spokane3110,62,76,3,12,3,73,205,225,91,138,430
Spokane3111,66,54,6,8,3,86,204,231,103,120,435
Spokane3112,7,12,0,0,0,0,33,38,0,19,71
Spokane3113,78,95,5,8,8,101,302,297,122,173,599
Spokane3114,80,105,8,14,3,107,276,300,132,185,576
Spokane3115,86,92,4,13,9,92,313,289,118,178,602
Spokane3116,75,96,8,12,8,100,318,307,128,171,625
Spokane3117,60,65,9,11,4,66,194,227,90,125,421
Spokane3118,84,79,6,11,4,66,301,192,87,163,493
Spokane3119,70,115,4,15,6,57,303,219,82,185,522
Spokane3120,78,89,10,23,3,78,302,256,114,167,558
Spokane3121,53,60,6,11,2,93,232,286,112,113,518
Spokane3122,113,116,6,12,21,102,374,244,141,229,618
Spokane3123,56,70,6,23,7,71,226,272,107,126,498
Spokane3124,83,87,7,17,3,100,274,276,127,170,550
Spokane3125,79,85,8,14,5,92,320,246,119,164,566
Spokane3126,17,18,1,4,0,21,51,84,26,35,135
Spokane3127,109,82,1,11,9,44,369,144,65,191,513
Spokane3128,79,115,2,9,3,90,331,272,104,194,603
Spokane3200,61,121,2,4,6,50,383,122,62,182,505
Spokane3201,130,155,5,8,17,82,545,191,112,285,736
Spokane3202,80,59,1,7,8,40,292,154,56,139,446
Spokane3203,96,154,2,22,12,56,454,185,92,250,639
Spokane3204,87,128,3,8,10,65,405,166,86,215,571
Spokane3205,106,111,3,10,20,59,334,175,92,217,509
Spokane3206,84,111,0,9,3,58,372,155,70,195,527
Spokane3207,52,75,4,5,3,39,243,166,51,127,409
Spokane3208,100,138,7,10,2,111,388,283,130,238,671
Spokane3209,100,136,9,24,6,134,416,364,173,236,780
Spokane3210,88,139,5,9,12,47,479,171,73,227,650
Spokane3211,89,118,11,12,21,50,442,163,94,207,605
Spokane3212,76,89,0,12,20,46,356,117,78,165,473
Spokane3213,131,144,7,23,22,75,515,221,127,275,736
Spokane3214,106,101,4,16,15,81,429,193,116,207,622
Spokane3215,41,101,6,12,2,43,288,136,63,142,424
Spokane3216,139,124,2,24,21,80,541,235,127,263,776
Spokane3217,124,103,8,26,15,116,467,362,165,227,829
Spokane3218,135,111,2,8,20,84,491,225,114,246,716
Spokane3219,102,64,2,14,32,88,354,200,136,166,554
Spokane3220,174,103,10,25,39,124,492,302,198,277,794
Spokane3221,89,151,14,14,13,120,431,393,161,240,824
Spokane3222,56,115,2,7,0,29,321,93,38,171,414
Spokane3223,62,115,1,6,6,33,360,121,46,177,481
Spokane3300,69,38,16,22,15,127,237,387,180,107,624
Spokane3301,126,103,10,27,28,165,411,391,230,229,802
Spokane3302,83,74,9,12,16,122,278,337,159,157,615
Spokane3303,80,96,5,13,11,99,330,334,128,176,664
Spokane3304,71,76,3,25,11,99,309,342,138,147,651
Spokane3305,68,65,3,11,5,79,239,234,98,133,473
Spokane3306,86,82,10,23,10,112,310,352,155,168,662
Spokane3307,71,52,6,17,14,67,251,210,104,123,461
Spokane3308,66,102,6,12,5,110,371,315,133,168,686
Spokane3309,80,88,4,17,5,108,331,299,134,168,630
Spokane3310,102,106,3,21,9,103,369,330,136,208,699
Spokane3311,58,51,5,19,7,53,197,205,84,109,402
Spokane3312,97,119,12,24,9,142,397,404,187,216,801
Spokane3313,100,118,11,23,16,154,446,410,204,218,856
Spokane3314,86,96,12,10,9,82,316,267,113,182,583
Spokane3315,97,129,3,19,7,93,402,315,122,226,717
Spokane3316,111,122,4,22,7,100,429,283,133,233,712
Spokane3317,150,126,5,23,19,127,499,388,174,276,887
Spokane3318,85,99,7,23,10,82,320,284,122,184,604
Spokane3319,74,104,7,17,3,87,317,252,114,178,569
Spokane3320,53,87,1,18,12,71,294,211,102,140,505
Spokane3321,72,119,10,14,14,99,378,286,137,191,664
Spokane3322,55,123,5,5,3,74,300,268,87,178,568
Spokane3323,94,138,9,15,4,96,451,295,124,232,746
Spokane3324,103,133,2,13,3,78,401,248,96,236,649
Spokane3325,130,148,9,15,16,100,476,238,140,278,714
Spokane3326,38,54,2,8,7,36,150,140,53,92,290
Spokane3327,88,125,3,9,6,62,351,208,80,213,559
Spokane3328,98,157,4,18,6,71,447,215,99,255,662
Spokane3329,102,121,9,14,4,51,432,172,78,223,604
Spokane4001,48,31,6,11,5,129,170,302,151,79,472
Spokane4002,59,53,15,25,16,182,188,460,238,112,648
Spokane4003,68,73,20,40,17,228,256,653,305,141,909
Spokane4004,56,68,8,36,12,171,200,502,227,124,702
Spokane4005,45,56,8,35,24,121,160,376,188,101,536
Spokane4006,79,71,11,23,30,187,313,515,251,150,828
Spokane4007,51,42,5,18,10,120,166,332,153,93,498
Spokane4008,27,24,3,27,7,145,133,340,182,51,473
Spokane4009,50,50,34,35,15,126,162,437,210,100,599
Spokane4010,59,59,9,28,10,158,178,407,205,118,585
Spokane4011,81,80,16,54,16,223,266,592,309,161,858
Spokane4012,71,74,16,45,26,250,298,700,337,145,998
Spokane4013,49,48,12,22,9,166,173,448,209,97,621
Spokane4014,50,65,8,25,10,93,234,259,136,115,493
Spokane4015,74,43,2,11,17,121,224,296,151,117,520
Spokane4016,87,70,10,35,33,156,266,417,234,157,683
Spokane4017,81,100,12,23,17,154,275,482,206,181,757
Spokane4018,39,39,5,14,8,143,143,340,170,78,483
Spokane4019,46,52,7,17,15,119,177,328,158,98,505
Spokane4020,79,71,15,30,12,196,229,531,253,150,760
Spokane4021,85,92,8,31,14,176,236,508,229,177,744
Spokane4022,55,79,10,26,15,157,219,441,208,134,660
Spokane4023,20,28,1,6,9,55,105,151,71,48,256
Spokane4024,55,31,8,15,22,124,184,313,169,86,497
Spokane4025,76,56,9,22,33,152,240,422,216,132,662
Spokane4026,42,41,13,34,15,151,227,463,213,83,690
Spokane4027,52,45,16,27,21,155,202,452,219,97,654
Spokane4028,94,84,13,20,29,210,381,466,272,178,847
Spokane4029,79,59,19,31,24,149,254,365,223,138,619
Spokane4030,48,60,9,28,4,98,198,252,139,108,450
Spokane4031,38,37,4,18,29,143,149,309,194,75,458
Spokane4032,43,42,10,12,3,106,140,264,131,85,404
Spokane4033,54,30,8,19,24,128,207,340,179,84,547
Spokane4034,46,52,6,21,8,119,175,345,154,98,520
Spokane4035,44,25,7,31,9,104,134,307,151,69,441
Spokane4200,67,74,10,17,8,107,258,257,142,141,515
Spokane4201,28,41,3,4,3,65,113,151,75,69,264
Spokane4300,45,60,4,17,15,120,222,357,156,105,579
Spokane4301,45,30,6,14,10,104,168,297,134,75,465
Spokane4302,85,88,2,28,18,136,323,402,184,173,725
Spokane4303,75,32,5,19,24,202,195,418,250,107,613
Spokane4304,75,71,7,17,8,127,283,345,159,146,628
Spokane4305,56,48,3,20,11,146,231,357,180,104,588
Spokane4306,70,48,13,22,28,213,262,456,276,118,718
Spokane4307,17,18,4,4,3,27,73,104,38,35,177
Spokane4400,91,90,9,14,5,144,364,387,172,181,751
Spokane4401,92,77,7,34,13,159,307,462,213,169,769
Spokane4402,101,98,5,21,10,148,316,369,184,199,685
Spokane4403,100,113,8,29,12,168,360,433,217,213,793
Spokane4404,72,84,5,26,13,166,283,467,210,156,750
Spokane4405,80,96,6,30,7,177,298,493,220,176,791
Spokane4406,105,85,8,20,9,161,318,385,198,190,703
Spokane4407,85,84,6,24,18,153,308,421,201,169,729
Spokane4408,97,86,9,27,21,195,282,486,252,183,768
Spokane4409,76,104,11,25,24,223,318,555,283,180,873
Spokane4410,92,92,10,17,21,121,326,403,169,184,729
Spokane4411,71,89,12,33,23,171,262,458,239,160,720
Spokane4412,70,53,10,32,12,98,214,276,152,123,490
Spokane4413,83,113,15,29,8,164,351,402,216,196,753
Spokane4414,94,98,13,21,4,186,309,488,224,192,797
Spokane4415,64,64,10,26,11,115,233,335,162,128,568
Spokane4416,83,85,10,28,7,149,288,448,194,168,736
Spokane4417,72,98,3,12,1,92,283,258,108,170,541
Spokane4418,77,90,6,29,11,159,293,418,205,167,711
Spokane4419,78,97,10,19,10,167,299,421,206,175,720
Spokane4420,39,43,7,7,7,77,161,219,98,82,380
Spokane4421,76,59,5,11,10,111,252,346,137,135,598
Spokane4422,84,63,14,36,13,134,283,392,197,147,675
Spokane4423,123,85,15,36,26,226,353,579,303,208,932
Spokane4424,76,55,6,23,20,125,232,402,174,131,634
Spokane4425,62,52,4,17,16,100,212,318,137,114,530
Spokane4426,38,49,8,27,9,85,162,218,129,87,380
Spokane4427,96,80,3,21,24,199,319,480,247,176,799
Spokane4428,41,71,8,17,8,126,186,328,159,112,514
Spokane4429,82,101,7,25,16,188,269,461,236,183,730
Spokane4430,91,98,12,36,15,201,352,555,264,189,907
Spokane4431,88,74,13,15,10,145,273,404,183,162,677
Spokane4432,91,92,7,23,9,147,335,496,186,183,831
Spokane4433,79,91,7,24,16,102,260,320,149,170,580
Spokane4434,104,105,11,43,24,202,358,564,280,209,922
Spokane4435,69,81,11,20,28,156,270,435,215,150,705
Spokane4436,78,75,19,30,19,197,341,562,265,153,903
Spokane4437,108,95,7,43,15,180,330,509,245,203,839
Spokane4438,91,53,10,32,26,251,302,670,319,144,972
Spokane4439,82,78,12,30,14,188,268,462,244,160,730
Spokane4440,59,100,9,24,9,175,296,491,217,159,787
Spokane4441,42,65,3,21,9,131,182,321,164,107,503
Spokane4442,50,68,5,16,7,84,183,302,112,118,485
Spokane4443,43,16,7,8,9,78,135,248,102,59,383
Spokane4444,92,67,15,38,13,182,271,458,248,159,729
Spokane4445,72,51,6,23,17,154,231,338,200,123,569
Spokane4446,64,59,2,16,7,82,222,212,107,123,434
Spokane4447,40,127,12,18,9,111,372,362,150,167,734
Spokane4448,51,76,9,33,10,128,221,342,180,127,563
Spokane4449,56,55,3,3,6,91,175,190,103,111,365
Spokane4450,36,50,1,12,2,74,120,226,89,86,346
Spokane4451,57,62,6,11,9,118,213,317,144,119,530
Spokane4452,66,87,6,23,11,155,298,446,195,153,744
Spokane4453,71,72,12,30,19,192,226,415,253,143,641
Spokane4454,79,68,5,16,8,121,210,273,150,147,483
Spokane4455,93,61,11,26,15,126,241,293,178,154,534
Spokane6000,51,39,3,23,5,118,153,306,149,90,459
Spokane6001,80,93,13,16,14,136,269,346,179,173,615
Spokane6002,27,22,3,3,5,44,112,134,55,49,246
Spokane6003,87,57,14,37,31,170,291,465,252,144,756
Spokane6004,54,48,11,21,17,98,205,259,147,102,464
Spokane6005,68,70,8,10,18,117,240,288,153,138,528
Spokane6006,60,72,15,16,18,124,232,353,173,132,585
Spokane6007,80,53,12,29,11,113,251,314,165,133,565
Spokane6008,68,56,2,24,10,97,233,278,133,124,511
Spokane6009,83,67,6,15,17,87,244,254,125,150,498
Spokane6010,4,4,1,0,2,30,12,67,33,8,79
Spokane6011,41,41,10,25,9,126,139,362,170,82,501
Spokane6012,32,45,7,19,5,111,116,317,142,77,433
Spokane6013,58,56,7,19,6,108,148,298,140,114,446
Spokane6014,47,44,6,14,11,100,152,244,131,91,396
Spokane6015,51,50,6,12,8,94,161,232,120,101,393
Spokane6016,53,46,5,16,12,132,157,332,165,99,489
Spokane6017,151,87,12,33,30,231,514,598,306,238,1112
Spokane6018,120,76,10,14,42,191,406,411,257,196,817
Spokane6019,121,98,9,28,27,177,481,403,241,219,884
Spokane6020,142,131,8,31,45,141,533,402,225,273,935
Spokane6021,105,98,6,21,13,139,406,353,179,203,759
Spokane6022,115,54,3,16,37,125,317,296,181,169,613
Spokane6023,44,29,4,10,11,94,156,221,119,73,377
Spokane6024,49,40,4,10,18,73,173,186,105,89,359
Spokane6025,56,41,5,22,6,139,141,326,172,97,467
Spokane6026,100,100,6,32,27,250,334,549,315,200,883
Spokane6027,70,79,17,18,13,146,237,382,194,149,619
Spokane6028,57,60,12,23,13,142,215,369,190,117,584
Spokane6029,70,75,10,31,6,145,212,357,192,145,569
Spokane6030,88,97,11,39,22,213,318,548,285,185,866
Spokane6031,65,54,3,12,15,113,192,270,143,119,462
Spokane6032,41,33,3,16,23,92,140,240,134,74,380
Spokane6033,89,93,12,34,36,222,372,564,304,182,936
Spokane6034,57,80,16,42,14,180,228,476,252,137,704
Spokane6035,46,27,3,19,7,94,175,306,123,73,481
Spokane6036,28,74,7,16,7,113,173,346,143,102,519
Spokane6037,34,42,7,32,7,106,143,291,152,76,434
Spokane6100,55,60,4,16,12,76,214,218,108,115,432
Spokane6101,52,101,4,23,2,119,273,337,148,153,610
Spokane6102,72,64,7,14,3,108,276,326,132,136,602
Spokane6103,49,31,0,5,9,36,133,100,50,80,233
Spokane6104,65,63,4,14,6,90,224,230,114,128,454
Spokane6105,93,47,3,9,13,93,256,224,118,140,480
Spokane6106,112,77,10,30,18,161,371,413,219,189,784
Spokane6107,72,48,5,5,8,69,207,242,87,120,449
Spokane6108,110,55,8,26,8,108,281,237,150,165,518
Spokane6109,57,62,6,11,10,88,208,257,115,119,465
Spokane6200,132,133,4,9,19,119,516,327,151,265,843
Spokane6201,75,84,8,9,11,108,356,291,136,159,647
Spokane6202,127,93,9,16,8,144,333,303,177,220,636
Spokane6203,175,175,10,10,11,60,648,181,91,350,829
Spokane6204,165,149,0,13,27,69,700,221,109,314,921
Spokane6205,150,136,7,9,22,62,636,188,100,286,824
Spokane6206,153,149,4,17,18,88,614,233,127,302,847
Spokane6207,133,73,5,21,51,147,421,314,224,206,735
Spokane6208,118,147,6,22,15,86,506,255,129,265,761
Spokane6209,118,123,8,12,13,78,499,213,111,241,712
Spokane6210,136,79,9,22,53,128,437,317,212,215,754
Spokane6211,88,101,5,13,11,87,325,237,116,189,562
Spokane6212,48,90,2,14,8,79,259,214,103,138,473
Spokane6213,100,115,9,17,11,142,403,426,179,215,829
Spokane6214,98,81,5,7,25,115,333,235,152,179,568
Spokane6215,104,161,11,15,21,100,538,273,147,265,811
Spokane6216,111,81,7,24,14,91,317,254,136,192,571
Spokane6217,138,99,8,16,23,110,465,281,157,237,746
Spokane6218,107,58,14,35,27,116,310,299,192,165,609
Spokane6219,75,69,10,16,26,96,353,297,148,144,650
Spokane6220,137,99,13,26,39,181,533,507,259,236,1040
Spokane6221,131,91,7,24,33,151,471,424,215,222,895
Spokane6222,60,21,5,5,39,129,227,249,178,81,476
Spokane6223,110,65,10,26,34,151,374,326,221,175,700
Spokane6224,126,117,4,15,26,140,508,357,185,243,865
Spokane6225,124,101,5,32,25,141,442,338,203,225,780
Spokane6300,147,67,9,28,33,259,407,534,329,214,941
Spokane6301,112,89,22,51,30,197,379,556,300,201,935
Spokane6302,67,29,2,21,17,108,217,230,148,96,447
Spokane6303,119,108,9,37,16,178,452,510,240,227,962
Spokane6304,88,105,9,41,19,162,390,467,231,193,857
Spokane6305,42,32,12,22,14,121,175,302,169,74,477
Spokane6306,51,48,5,25,17,163,274,480,210,99,754
Spokane6307,47,39,5,25,13,90,155,270,133,86,425
Spokane6308,44,47,9,20,8,88,176,222,125,91,398
Spokane6309,84,73,8,21,24,138,291,394,191,157,685
Spokane6310,76,49,11,26,16,77,275,264,130,125,539
Spokane6311,68,69,12,22,12,106,241,288,152,137,529
Spokane6312,82,52,11,17,22,108,241,261,158,134,502
Spokane6313,81,75,8,25,9,117,353,361,159,156,714
Spokane6314,79,73,4,13,10,110,293,305,137,152,598
Spokane6315,60,55,5,6,13,67,201,188,91,115,389
Spokane6316,58,55,1,6,19,64,254,175,90,113,429
Spokane6317,59,57,7,25,17,102,252,272,151,116,524
Spokane6318,72,47,4,20,17,125,270,280,166,119,550
Spokane6400,67,76,7,22,13,113,239,305,155,143,544
Spokane6401,35,63,2,13,1,88,152,186,104,98,338
Spokane6402,93,100,6,33,20,180,366,456,239,193,822
Spokane6500,13,45,2,44,14,44,117,223,104,58,340
Spokane6600,76,86,8,22,16,126,264,330,172,162,594
Spokane6601,38,56,6,29,23,133,177,416,191,94,593
Spokane6602,55,75,13,14,21,135,206,380,183,130,586
Spokane6700,70,93,6,28,17,105,284,267,156,163,551
Spokane6701,65,147,9,10,9,89,362,231,117,212,593
Spokane6702,40,131,5,12,5,69,312,212,91,171,524
Spokane6703,83,109,6,14,10,69,319,219,99,192,538
Spokane6704,68,132,8,21,12,113,376,369,154,200,745
Spokane7000,88,106,11,35,27,252,300,647,325,194,947
Spokane7001,43,47,9,30,15,143,132,400,197,90,532
Spokane7002,30,47,10,26,12,138,119,383,186,77,502
Spokane7003,57,58,9,45,16,171,175,450,241,115,625
Spokane7004,58,59,11,37,6,259,166,635,313,117,801
Spokane7005,71,103,16,49,27,306,261,685,398,174,946
Spokane7006,67,58,10,40,13,200,224,549,263,125,773
Spokane7007,51,60,4,21,15,185,177,458,225,111,635
Spokane7008,73,74,9,36,21,251,196,645,317,147,841
Spokane7009,61,85,11,38,25,261,252,700,335,146,952
Spokane7010,39,59,11,20,8,153,133,374,192,98,507
Spokane7011,33,26,7,36,6,104,99,330,153,59,429
Spokane7012,63,56,7,25,18,203,224,466,253,119,690
Spokane7013,44,38,10,36,20,181,153,445,247,82,598
Spokane7014,71,55,12,19,9,153,203,426,193,126,629
Spokane7015,67,57,10,29,22,166,195,409,227,124,604
Spokane7016,80,101,25,40,23,201,344,629,289,181,973
Spokane7017,55,65,12,31,21,187,271,457,251,120,728
Spokane7018,78,79,22,25,30,190,323,508,267,157,831
Spokane7019,57,64,12,36,17,163,228,426,228,121,654
Spokane7020,85,44,9,29,19,173,299,438,230,129,737
Spokane7021,40,51,1,34,15,91,179,309,141,91,488
Spokane7022,60,77,8,18,16,123,276,315,165,137,591
Spokane7023,80,69,7,24,14,120,237,294,165,149,531
Spokane7024,100,81,10,27,33,269,363,575,339,181,938
Spokane7025,98,66,10,32,16,217,301,515,275,164,816
Spokane7026,75,63,13,18,34,139,289,385,204,138,674
Spokane7027,71,78,10,18,21,108,251,300,157,149,551
Spokane7028,101,78,22,26,27,202,358,562,277,179,920
Spokane7029,57,81,3,30,10,144,209,347,187,138,556
Spokane7030,94,64,17,27,25,157,302,441,226,158,743
Spokane7031,67,79,15,39,27,119,288,350,200,146,638
Spokane7032,101,121,7,26,24,145,383,371,202,222,754
Spokane7033,50,48,8,19,14,83,162,237,124,98,399
Spokane7034,32,48,6,10,3,95,178,238,114,80,416
Spokane7035,29,51,6,24,8,133,120,316,171,80,436
Spokane7036,94,56,17,22,30,117,217,288,186,150,505
Spokane7300,49,50,5,24,10,181,179,419,220,99,598
Spokane7301,51,46,14,23,8,134,156,346,179,97,502
Spokane7302,55,49,13,19,7,119,132,329,158,104,461
Spokane9000,58,66,8,39,9,193,181,462,249,124,643
Spokane9001,48,79,4,24,7,127,200,334,162,127,534
Spokane9002,21,45,6,39,9,123,107,331,177,66,438
Spokane9003,29,16,14,20,9,97,80,247,140,45,327
Spokane9004,34,34,6,38,18,176,137,436,238,68,573
Spokane9005,6,14,1,12,4,63,49,182,80,20,231
Spokane9006,40,47,16,27,16,216,159,580,275,87,739
Spokane9007,10,10,5,7,7,53,36,139,72,20,175
Spokane9008,6,6,1,4,1,41,14,91,47,12,105
Spokane9300,16,15,6,6,3,26,37,81,41,31,118
Spokane9400,4,4,0,0,0,0,10,36,0,8,46
Spokane9500,21,25,4,5,9,57,68,168,75,46,236
Spokane9600,5,10,0,7,0,29,24,66,36,15,90
Spokane9700,12,23,2,13,5,59,56,151,79,35,207
Stevens1,22,32,9,27,6,144,96,381,186,54,477
Stevens10,42,64,8,21,3,151,156,346,183,106,502
Stevens101,38,43,11,11,6,108,115,268,136,81,383
Stevens102,24,14,0,5,2,51,74,114,58,38,188
Stevens103,40,33,8,10,10,76,132,164,104,73,296
Stevens104,33,29,5,4,5,75,80,143,89,62,223
Stevens105,22,29,8,6,1,53,51,122,68,51,173
Stevens106,25,20,6,6,9,47,83,140,68,45,223
Stevens107,27,26,6,7,6,60,68,177,79,53,245
Stevens108,41,43,13,16,16,140,130,292,185,84,422
Stevens109,48,46,7,14,4,124,128,272,149,94,400
Stevens11,10,18,2,11,0,45,34,103,58,28,137
Stevens110,37,30,6,2,8,56,96,121,72,67,217
Stevens111,24,20,4,6,7,88,58,175,105,44,233
Stevens114,28,46,12,11,8,110,106,274,141,74,380
Stevens115,27,17,6,6,0,68,52,198,80,44,250
Stevens116,8,18,0,1,2,20,26,45,23,26,71
Stevens117,11,16,6,1,1,47,37,93,55,27,130
Stevens118,8,17,0,2,0,26,24,57,28,25,81
Stevens12,80,48,12,20,16,211,185,445,259,128,630
Stevens13,48,30,2,14,11,112,120,257,139,78,377
Stevens14,18,13,5,8,3,67,43,160,83,31,203
Stevens15,41,40,12,33,9,200,118,409,254,81,527
Stevens16,14,46,4,8,1,26,87,92,39,60,179
Stevens19,18,33,3,10,6,91,79,160,110,51,239
Stevens20,9,11,3,5,0,35,32,79,43,20,111
Stevens21,9,26,4,12,9,135,44,292,160,35,336
Stevens22,4,9,1,7,0,20,13,68,28,13,81
Stevens24,41,42,0,4,0,24,220,55,28,83,275
Stevens25,58,38,13,43,10,186,141,520,252,96,661
Stevens26,30,49,4,13,7,89,102,234,113,79,336
Stevens27,31,45,12,31,8,185,148,454,236,76,602
Stevens28,53,39,5,13,6,94,146,256,118,92,402
Stevens29,57,50,5,23,7,199,173,448,234,107,621
Stevens3,42,41,5,29,4,155,119,364,193,83,483
Stevens39,69,67,13,33,10,182,249,496,238,136,745
Stevens4,12,27,2,11,5,102,67,205,120,39,272
Stevens40,33,55,7,23,6,167,140,356,203,88,496
Stevens41,59,72,9,20,9,137,165,417,175,131,582
Stevens42,23,47,11,11,7,118,87,269,147,70,356
Stevens43,28,42,15,27,8,206,102,475,256,70,577
Stevens44,62,64,13,28,18,221,174,522,280,126,696
Stevens45,0,0,8,20,10,113,104,264,151,0,368
Stevens46,0,0,1,6,0,27,23,73,34,0,96
Stevens47,36,30,5,9,3,91,79,215,108,66,294
Stevens48,18,25,9,10,6,123,78,314,148,43,392
Stevens49,17,35,8,15,9,152,96,331,184,52,427
Stevens5,39,102,11,24,5,218,186,470,258,141,656
Stevens50,24,28,4,18,6,74,67,213,102,52,280
Stevens51,28,47,8,38,5,154,120,451,205,75,571
Stevens52,18,25,3,15,11,90,79,241,119,43,320
Stevens53,26,41,11,14,8,147,92,329,180,67,421
Stevens54,46,42,5,20,7,156,131,353,188,88,484
Stevens55,12,20,3,9,6,74,58,204,92,32,262
Stevens6,48,64,9,30,11,214,161,487,264,112,648
Stevens7,20,31,5,7,1,78,58,142,91,51,200
Stevens8,26,39,3,21,16,166,72,354,206,65,426
Stevens9,21,27,1,10,5,84,63,202,100,48,265
Thurston100,104,96,5,6,11,72,452,203,94,200,655
Thurston101,75,76,5,8,9,50,275,129,72,151,404
Thurston102,106,96,0,5,11,43,398,93,59,202,491
Thurston103,56,40,1,4,4,38,213,82,47,96,295
Thurston104,37,48,2,4,6,47,143,128,59,85,271
Thurston105,74,74,5,17,14,92,269,252,128,148,521
Thurston106,70,64,6,16,22,106,300,307,150,134,607
Thurston107,71,68,1,10,5,54,275,147,70,139,422
Thurston109,40,46,0,10,9,33,175,127,52,86,302
Thurston110,36,54,4,6,4,50,161,111,64,90,272
Thurston111,62,33,2,13,4,74,206,212,93,95,418
Thurston112,73,108,2,13,7,101,332,242,123,181,574
Thurston113,65,62,6,15,6,80,231,172,107,127,403
Thurston115,119,78,0,13,21,110,391,280,144,197,671
Thurston116,43,52,4,13,14,105,186,244,136,95,430
Thurston117,17,7,1,2,2,10,45,19,15,24,64
Thurston118,68,85,9,2,16,125,324,302,152,153,626
Thurston119,115,109,3,32,14,138,436,361,187,224,797
Thurston120,67,49,1,7,14,55,259,164,77,116,423
Thurston121,126,31,4,13,19,102,270,233,138,157,503
Thurston122,80,107,8,16,25,129,378,391,178,187,769
Thurston123,91,57,10,10,18,104,301,231,142,148,532
Thurston124,44,44,4,9,5,71,141,200,89,88,341
Thurston125,57,88,1,20,6,120,214,337,147,145,551
Thurston126,40,24,6,5,5,83,115,211,99,64,326
Thurston127,15,23,2,7,8,44,69,122,61,38,191
Thurston128,40,75,1,6,7,123,161,308,137,115,469
Thurston129,8,73,0,0,0,0,207,4,0,81,211
Thurston130,15,34,1,4,3,37,67,103,45,49,170
Thurston131,41,48,1,7,3,52,190,123,63,89,313
Thurston132,67,67,1,10,5,47,253,152,63,134,405
Thurston133,42,56,3,7,8,49,207,152,67,98,359
Thurston134,91,57,3,6,18,54,301,156,81,148,457
Thurston135,68,53,3,1,16,50,291,144,70,121,435
Thurston136,85,130,3,5,15,40,486,195,63,215,681
Thurston139,107,115,2,12,16,85,509,216,115,222,725
Thurston140,55,104,3,3,8,63,259,162,77,159,421
Thurston141,49,53,5,5,7,60,196,151,77,102,347
Thurston143,0,0,0,0,0,0,0,0,0,0,0
Thurston144,75,74,3,20,10,93,311,304,126,149,615
Thurston145,49,69,3,12,11,63,239,207,89,118,446
Thurston146,79,76,3,23,12,105,298,342,143,155,640
Thurston147,62,61,4,9,6,120,259,263,139,123,522
Thurston148,32,39,5,12,3,76,120,230,96,71,350
Thurston149,68,105,6,18,15,176,340,417,215,173,757
Thurston150,62,79,7,9,2,154,228,426,172,141,654
Thurston151,82,82,14,15,23,166,350,436,218,164,786
Thurston153,57,52,8,12,11,144,213,398,175,109,611
Thurston154,44,49,8,12,2,114,144,304,136,93,448
Thurston155,24,37,5,6,6,36,101,114,53,61,215
Thurston156,16,42,3,8,4,66,104,210,81,58,314
Thurston157,8,7,0,2,2,33,29,75,37,15,104
Thurston158,34,61,9,5,13,93,175,278,120,95,453
Thurston160,90,63,5,10,20,83,306,254,118,153,560
Thurston161,41,29,0,0,0,0,159,61,0,70,220
Thurston162,52,39,3,6,7,42,177,123,58,91,300
Thurston163,68,66,2,8,11,67,288,174,88,134,462
Thurston164,54,70,7,8,1,61,213,187,77,124,400
Thurston165,100,138,6,20,11,138,448,396,175,238,844
Thurston166,38,50,4,15,8,33,121,160,60,88,281
Thurston167,36,27,2,3,0,24,117,86,29,63,203
Thurston168,76,44,2,7,9,67,247,188,85,120,435
Thurston169,58,58,4,14,3,49,213,181,70,116,394
Thurston170,47,44,7,10,5,124,159,318,146,91,477
Thurston171,51,39,2,10,6,62,199,195,80,90,394
Thurston172,93,43,3,3,16,50,308,148,72,136,456
Thurston173,39,46,1,2,3,46,167,129,52,85,296
Thurston174,100,75,1,6,9,45,366,120,61,175,486
Thurston175,101,94,3,8,20,41,444,145,72,195,589
Thurston176,83,88,4,8,10,100,344,258,122,171,602
Thurston178,73,78,3,15,4,78,283,229,100,151,512
Thurston179,65,124,5,20,7,164,281,445,196,189,726
Thurston180,56,48,3,9,11,67,175,195,90,104,370
Thurston183,65,40,1,3,9,53,230,118,66,105,348
Thurston184,20,32,3,3,0,35,107,84,41,52,191
Thurston185,54,48,5,4,11,48,189,130,68,102,319
Thurston186,92,91,1,9,26,64,418,196,100,183,614
Thurston187,59,111,6,13,11,89,316,295,119,170,611
Thurston189,67,49,7,8,13,63,244,186,91,116,430
Thurston190,35,33,3,0,7,38,120,112,48,68,232
Thurston191,103,101,2,12,27,96,431,273,137,204,704
Thurston192,56,60,2,4,10,97,221,233,113,116,454
Thurston193,51,59,3,6,5,75,188,209,89,110,397
Thurston194,150,95,11,22,34,140,488,429,207,245,917
Thurston195,60,81,4,12,6,46,282,143,68,141,425
Thurston196,51,53,1,12,4,92,198,208,109,104,406
Thurston197,104,97,5,16,22,134,397,362,177,201,759
Thurston198,55,80,3,28,15,215,261,561,261,135,822
Thurston199,79,87,5,23,9,223,316,552,260,166,868
Thurston201,71,116,1,8,9,30,321,119,48,187,440
Thurston202,74,129,4,9,8,41,396,166,62,203,562
Thurston203,67,103,5,8,13,33,357,123,59,170,480
Thurston204,85,80,1,5,5,47,275,99,58,165,374
Thurston205,53,142,2,5,3,21,419,55,31,195,474
Thurston206,125,119,9,10,17,71,513,224,107,244,737
Thurston207,41,92,0,1,3,20,222,56,24,133,278
Thurston208,78,54,2,4,19,45,300,122,70,132,422
Thurston209,109,145,1,15,18,59,591,202,93,254,793
Thurston210,99,115,0,0,6,10,387,45,16,214,432
Thurston211,84,84,3,3,2,11,350,34,19,168,384
Thurston212,68,90,3,7,7,38,357,122,55,158,479
Thurston213,72,121,0,0,0,0,394,59,0,193,453
Thurston214,38,63,3,2,1,12,236,54,18,101,290
Thurston215,68,138,3,2,9,25,461,87,39,206,548
Thurston216,15,12,1,2,0,7,43,21,10,27,64
Thurston217,56,40,0,6,4,39,174,94,49,96,268
Thurston218,58,134,1,5,5,33,388,74,44,192,462
Thurston219,73,118,0,2,6,41,387,102,49,191,489
Thurston220,33,72,0,0,0,0,215,40,0,105,255
Thurston221,129,147,1,5,19,41,491,95,66,276,586
Thurston223,58,193,2,2,10,28,454,100,42,251,554
Thurston224,95,79,1,6,11,17,339,68,35,174,407
Thurston225,63,49,2,2,13,28,233,68,45,112,301
Thurston226,75,103,0,4,1,17,355,34,22,178,389
Thurston227,29,49,1,2,4,24,192,71,31,78,263
Thurston228,77,112,1,3,5,20,409,66,29,189,475
Thurston229,103,62,2,16,10,65,302,154,93,165,456
Thurston230,57,109,0,5,2,19,322,57,26,166,379
Thurston231,54,49,2,5,14,34,214,135,55,103,349
Thurston232,93,69,3,5,11,77,394,169,96,162,563
Thurston235,172,115,4,14,38,77,660,234,133,287,894
Thurston236,36,52,0,2,3,27,161,60,32,88,221
Thurston237,47,42,1,5,8,43,186,99,57,89,285
Thurston238,24,30,1,1,2,18,101,39,22,54,140
Thurston239,75,86,2,5,9,35,306,94,51,161,400
Thurston240,78,45,1,8,9,18,262,59,36,123,321
Thurston241,100,91,0,1,6,27,367,54,34,191,421
Thurston242,53,63,0,3,8,17,232,44,28,116,276
Thurston243,113,117,3,6,8,34,415,98,51,230,513
Thurston244,33,75,1,0,4,4,219,19,9,108,238
Thurston245,61,56,0,5,4,26,269,103,35,117,372
Thurston246,87,78,2,7,3,72,322,167,84,165,489
Thurston247,89,135,2,3,7,37,439,112,49,224,551
Thurston248,90,142,4,18,19,85,468,249,126,232,717
Thurston249,84,133,1,4,1,24,451,58,30,217,509
Thurston250,42,124,2,5,2,23,386,81,32,166,467
Thurston251,7,12,1,2,3,20,62,44,26,19,106
Thurston252,60,45,2,6,6,15,188,37,29,105,225
Thurston253,88,82,4,14,8,41,242,124,67,170,366
Thurston254,43,80,2,0,2,9,254,34,13,123,288
Thurston255,41,61,0,5,4,35,265,118,44,102,383
Thurston256,108,86,7,19,10,73,343,178,109,194,521
Thurston257,22,96,4,5,3,19,213,70,31,118,283
Thurston258,106,71,1,7,11,72,338,155,91,177,493
Thurston259,49,86,0,3,9,28,301,83,40,135,384
Thurston260,80,54,4,11,4,46,316,163,65,134,479
Thurston28,9,14,0,0,0,0,35,73,0,23,108
Thurston30,71,115,4,28,14,195,320,561,241,186,881
Thurston301,23,46,1,3,9,24,117,71,37,69,188
Thurston302,46,58,6,6,7,34,224,132,53,104,356
Thurston303,57,60,8,12,5,51,214,196,76,117,410
Thurston304,36,64,2,7,3,35,156,119,47,100,275
Thurston305,48,35,1,9,9,31,148,104,50,83,252
Thurston306,26,30,0,0,0,0,116,73,0,56,189
Thurston307,59,72,5,3,11,56,270,134,75,131,404
Thurston308,56,53,4,7,8,47,243,108,66,109,351
Thurston309,44,49,0,6,4,42,180,108,52,93,288
Thurston31,26,38,0,4,1,18,79,84,23,64,163
Thurston310,168,55,15,11,28,52,349,121,106,223,470
Thurston311,120,46,2,3,11,46,223,85,62,166,308
Thurston313,36,46,2,0,3,31,150,96,36,82,246
Thurston314,21,42,0,5,1,24,117,101,30,63,218
Thurston315,69,76,3,7,9,82,303,208,101,145,511
Thurston316,114,34,8,8,16,38,238,78,70,148,316
Thurston317,49,56,2,11,10,62,252,204,85,105,456
Thurston318,79,67,4,16,19,66,255,193,105,146,448
Thurston319,38,60,2,11,6,60,157,119,79,98,276
Thurston32,33,63,1,16,4,136,166,372,157,96,538
Thurston320,27,32,2,5,2,33,114,71,42,59,185
Thurston321,42,44,2,8,5,35,125,95,50,86,220
Thurston322,61,48,4,5,12,36,202,104,57,109,306
Thurston323,30,37,4,7,3,25,126,85,39,67,211
Thurston324,124,74,12,26,21,141,402,365,200,198,767
Thurston327,62,71,8,6,6,62,286,186,82,133,472
Thurston328,30,27,2,4,10,47,146,127,63,57,273
Thurston329,97,83,5,9,9,75,363,245,98,180,608
Thurston33,92,81,7,27,19,86,384,313,139,173,697
Thurston330,100,101,7,31,18,105,419,308,161,201,727
Thurston331,48,54,3,12,2,50,239,168,67,102,407
Thurston332,79,82,2,17,7,57,354,229,83,161,583
Thurston333,39,58,0,5,4,38,174,108,47,97,282
Thurston334,31,39,1,6,1,23,114,97,31,70,211
Thurston335,38,26,2,7,5,17,143,61,31,64,204
Thurston336,36,46,0,10,10,63,301,228,83,82,529
Thurston337,18,20,1,4,3,16,70,52,24,38,122
Thurston339,151,89,5,21,13,114,459,254,153,240,713
Thurston340,88,78,10,25,13,79,376,259,127,166,635
Thurston341,55,36,3,19,11,64,219,174,97,91,393
Thurston342,73,50,2,18,8,81,288,236,109,123,524
Thurston343,67,50,5,12,12,65,274,211,94,117,485
Thurston344,27,40,1,7,2,34,159,140,44,67,299
Thurston345,38,40,0,14,6,26,208,143,46,78,351
Thurston346,182,85,9,29,57,186,556,452,281,267,1008
Thurston347,208,70,6,16,61,173,452,321,256,278,773
Thurston348,76,38,5,15,15,91,276,246,126,114,522
Thurston349,73,21,1,3,13,36,166,110,53,94,276
Thurston35,30,40,0,1,5,26,152,54,32,70,206
Thurston36,45,38,4,8,8,86,185,232,106,83,417
Thurston38,0,0,0,0,0,0,2,2,0,0,4
Thurston39,52,31,1,8,8,39,157,96,56,83,253
Thurston401,59,85,4,8,8,35,332,172,55,144,504
Thurston402,78,99,4,5,9,34,330,103,52,177,433
Thurston403,74,107,0,6,8,44,342,154,58,181,496
Thurston404,53,78,1,3,0,46,258,130,50,131,388
Thurston405,81,80,3,6,12,78,300,233,99,161,533
Thurston406,108,89,5,17,17,71,453,224,110,197,677
Thurston407,56,67,3,5,8,48,240,141,64,123,381
Thurston408,72,102,6,3,7,47,366,176,63,174,542
Thurston409,51,66,4,11,10,82,217,164,107,117,381
Thurston410,114,100,6,12,20,118,344,262,156,214,606
Thurston411,81,92,9,24,22,90,346,260,145,173,606
Thurston412,74,73,6,7,9,41,296,134,63,147,430
Thurston413,47,36,0,1,4,25,121,65,30,83,186
Thurston414,34,36,1,9,6,24,160,104,40,70,264
Thurston415,84,99,5,16,11,88,417,236,120,183,653
Thurston42,0,0,0,0,0,0,0,0,0,0,0
Thurston424,51,33,5,6,9,63,191,169,83,84,360
Thurston427,74,61,1,13,7,64,332,203,85,135,535
Thurston428,60,96,2,14,19,108,378,321,143,156,699
Thurston429,0,0,0,0,0,0,0,0,0,0,0
Thurston43,22,33,0,0,0,0,112,106,0,55,218
Thurston430,0,0,0,0,0,0,0,0,0,0,0
Thurston431,61,38,2,11,9,49,212,197,71,99,409
Thurston432,145,120,5,17,21,125,512,380,168,265,892
Thurston44,67,72,1,8,5,48,236,112,62,139,348
Thurston45,34,38,1,1,2,70,115,193,74,72,308
Thurston46,77,91,8,13,9,141,240,375,171,168,615
Thurston47,63,53,5,9,8,78,240,198,100,116,438
Thurston48,24,31,6,13,1,75,99,180,95,55,279
Thurston49,48,58,5,10,5,64,186,182,84,106,368
Thurston50,20,39,3,5,4,55,138,154,67,59,292
Thurston501,38,58,2,6,3,56,137,166,67,96,303
Thurston502,41,46,2,5,9,70,159,170,86,87,329
Thurston51,27,17,6,4,8,52,101,139,70,44,240
Thurston52,38,38,4,11,6,132,158,346,153,76,504
Thurston53,65,105,5,12,7,142,181,375,166,170,556
Thurston54,38,41,7,12,12,107,179,301,138,79,480
Thurston55,29,62,3,17,4,78,144,266,102,91,410
Thurston57,18,16,6,6,5,52,85,138,69,34,223
Thurston58,66,80,2,13,8,56,249,177,79,146,426
Thurston59,69,63,2,21,24,79,287,220,126,132,507
Thurston60,49,57,2,18,9,150,194,374,179,106,568
Thurston601,38,49,8,11,8,75,155,247,102,87,402
Thurston602,22,39,1,4,2,58,113,179,65,61,292
Thurston62,68,89,4,15,6,138,296,375,163,157,671
Thurston63,63,88,1,2,5,43,263,110,51,151,373
Thurston65,77,64,3,15,13,102,277,273,133,141,550
Thurston66,62,54,2,6,13,53,254,128,74,116,382
Thurston67,0,0,0,0,0,0,0,0,0,0,0
Thurston68,0,0,0,0,0,0,0,0,0,0,0
Thurston69,0,0,0,0,0,0,8,18,0,0,26
Thurston70,0,0,0,1,2,4,15,13,7,0,28
Thurston701,62,67,3,5,4,100,198,284,112,129,482
Thurston702,25,51,4,18,10,93,163,314,125,76,477
Thurston703,36,80,5,14,9,128,217,423,156,116,640
Thurston704,61,93,4,27,6,155,318,513,192,154,831
Thurston74,53,71,2,10,6,97,176,235,115,124,411
Thurston75,22,10,1,3,7,14,77,53,25,32,130
Thurston76,52,47,2,4,11,48,167,138,65,99,305
Thurston77,11,6,0,0,0,0,19,80,0,17,99
Thurston78,38,28,4,5,11,45,133,135,65,66,268
Thurston79,23,50,9,3,5,47,148,129,64,73,277
Thurston80,17,14,0,4,1,35,75,75,40,31,150
Thurston801,24,34,2,4,1,46,77,119,53,58,196
Thurston81,35,40,0,8,4,51,114,114,63,75,228
Thurston82,16,27,0,0,0,0,79,61,0,43,140
Thurston83,7,11,0,2,3,18,42,59,23,18,101
Thurston84,23,17,2,2,4,22,92,74,30,40,166
Thurston86,32,47,3,3,3,47,161,129,56,79,290
Thurston88,59,57,3,5,15,73,230,176,96,116,406
Thurston89,54,65,2,9,15,109,284,315,135,119,599
Thurston90,121,96,1,8,25,70,432,218,104,217,650
Thurston91,73,48,5,12,10,115,248,271,142,121,519
Thurston92,74,73,13,18,9,92,343,242,132,147,585
Thurston93,23,42,4,2,3,32,111,80,41,65,191
Thurston94,66,90,5,11,14,61,301,190,91,156,491
Thurston95,76,97,3,12,17,57,289,164,89,173,453
Thurston96,42,44,0,15,11,90,204,237,116,86,441
Thurston97,16,14,1,4,5,22,96,54,32,30,150
Thurston98,68,72,9,9,20,89,291,243,127,140,534
Thurston99,101,123,4,12,20,88,462,284,124,224,746
Walla Walla1,29,43,4,6,10,81,136,214,101,72,350
Walla Walla10,48,57,1,0,6,31,200,74,38,105,274
Walla Walla11,55,74,4,9,14,84,243,193,111,129,436
Walla Walla12,21,48,2,8,11,42,142,119,63,69,261
Walla Walla13,100,78,12,16,31,204,342,398,263,178,740
Walla Walla14,63,8,8,10,21,89,143,220,128,71,363
Walla Walla16,95,95,9,14,21,97,417,300,141,190,717
Walla Walla17,85,82,10,26,26,213,388,524,275,167,912
Walla Walla18,104,80,8,32,37,172,317,361,249,184,678
Walla Walla2,31,54,1,8,0,51,146,117,60,85,263
Walla Walla20,28,40,1,14,0,13,137,76,28,68,213
Walla Walla21,31,40,2,1,6,60,198,140,69,71,338
Walla Walla22,74,90,14,24,7,154,310,365,199,164,675
Walla Walla23,40,50,7,4,11,46,193,135,68,90,328
Walla Walla24,38,48,4,6,8,57,153,188,75,86,341
Walla Walla25,32,71,3,6,2,74,193,144,85,103,337
Walla Walla26,32,50,6,8,7,88,133,214,109,82,347
Walla Walla28,80,58,8,10,16,168,223,317,202,138,540
Walla Walla29,43,78,1,10,9,55,222,161,75,121,383
Walla Walla3,42,57,4,5,15,140,179,323,164,99,502
Walla Walla31,32,32,9,10,14,125,139,255,158,64,394
Walla Walla33,15,8,4,0,0,38,40,91,42,23,131
Walla Walla34,30,33,8,18,16,199,105,466,241,63,571
Walla Walla35,47,42,1,3,7,102,146,181,113,89,327
Walla Walla36,41,45,17,13,14,157,188,363,201,86,551
Walla Walla37,56,43,17,23,21,157,212,390,218,99,602
Walla Walla38,50,47,0,0,0,0,155,496,0,97,651
Walla Walla39,2,2,0,0,0,0,2,37,0,4,39
Walla Walla4,76,60,14,8,24,122,267,255,168,136,522
Walla Walla40,10,19,5,9,6,42,54,118,62,29,172
Walla Walla41,21,20,5,10,5,102,63,233,122,41,296
Walla Walla42,10,8,1,2,0,22,0,0,25,18,0
Walla Walla43,0,0,0,0,0,0,0,0,0,0,0
Walla Walla44,10,21,8,10,10,69,62,201,97,31,263
Walla Walla45,7,3,2,3,0,19,17,42,24,10,59
Walla Walla46,16,32,6,8,12,85,77,201,111,48,278
Walla Walla47,10,14,2,0,5,36,33,102,43,24,135
Walla Walla49,4,7,1,6,3,28,18,73,38,11,91
Walla Walla5,62,74,5,14,7,56,250,144,82,136,394
Walla Walla50,25,30,5,8,8,87,99,226,108,55,325
Walla Walla51,37,26,3,9,13,51,138,150,76,63,288
Walla Walla52,98,55,11,20,29,216,267,486,276,153,753
Walla Walla53,43,60,17,29,25,173,222,451,244,103,673
Walla Walla54,21,20,4,17,7,113,85,274,141,41,359
Walla Walla55,24,28,8,17,6,153,96,335,184,52,431
Walla Walla56,0,0,0,0,0,0,2,4,0,0,6
Walla Walla57,32,16,12,11,10,88,104,195,121,48,299
Walla Walla58,0,0,0,2,3,14,21,33,19,0,54
Walla Walla59,4,3,2,11,1,16,19,42,30,7,61
Walla Walla6,34,53,2,7,3,31,148,86,43,87,234
Walla Walla60,20,9,4,6,1,51,38,124,62,29,162
Walla Walla61,81,68,30,22,26,143,283,357,221,149,640
Walla Walla62,46,67,18,13,19,130,214,379,180,113,593
Walla Walla63,52,57,36,20,24,132,261,403,212,109,664
Walla Walla64,2,12,4,11,2,32,18,93,49,14,111
Walla Walla65,45,70,11,13,13,176,150,404,213,115,554
Walla Walla66,88,97,35,18,15,181,326,457,249,185,783
Walla Walla67,57,48,14,10,19,142,207,304,185,105,511
Walla Walla68,10,6,6,2,2,26,24,62,36,16,86
Walla Walla7,83,55,8,9,10,42,290,97,69,138,387
Walla Walla8,44,75,7,3,10,74,178,192,94,119,370
Walla Walla9,60,58,5,10,11,98,223,233,124,118,456
Whatcom101,152,132,1,6,5,92,512,211,104,284,723
Whatcom102,50,78,6,30,5,146,222,274,187,128,496
Whatcom103,106,86,5,8,22,134,328,275,169,192,603
Whatcom104,49,35,5,17,10,111,174,210,143,84,384
Whatcom105,36,63,3,4,4,71,190,140,82,99,330
Whatcom106,80,90,7,12,11,132,269,302,162,170,571
Whatcom107,96,119,4,19,13,212,350,412,248,215,762
Whatcom108,89,122,4,13,8,172,388,416,197,211,804
Whatcom110,49,69,3,20,6,165,205,345,194,118,550
Whatcom111,54,74,6,29,3,156,244,372,194,128,616
Whatcom112,39,39,3,9,7,73,125,178,92,78,303
Whatcom113,60,47,5,22,11,178,202,347,216,107,549
Whatcom114,36,40,10,18,4,100,135,223,132,76,358
Whatcom115,51,59,12,29,9,192,187,444,242,110,631
Whatcom116,15,23,6,32,7,150,80,301,195,38,381
Whatcom117,11,19,11,18,21,166,73,387,216,30,460
Whatcom118,26,78,11,37,14,237,167,516,299,104,683
Whatcom119,60,43,0,14,8,88,198,185,110,103,383
Whatcom120,44,78,2,20,10,150,192,370,182,122,562
Whatcom121,32,61,7,36,4,96,175,250,143,93,425
Whatcom122,40,45,3,24,9,100,152,253,136,85,405
Whatcom123,38,47,7,15,1,88,150,219,111,85,369
Whatcom124,24,49,5,25,5,97,132,234,132,73,366
Whatcom125,37,75,18,39,9,195,216,413,261,112,629
Whatcom126,93,130,9,21,8,231,391,448,269,223,839
Whatcom127,78,111,9,29,12,193,347,446,243,189,793
Whatcom129,79,82,4,16,9,114,289,325,143,161,614
Whatcom130,21,47,4,13,10,93,142,219,120,68,361
Whatcom131,71,104,10,47,14,176,321,394,247,175,715
Whatcom132,52,69,2,14,6,118,243,249,140,121,492
Whatcom133,97,102,1,10,3,41,470,117,55,199,587
Whatcom134,124,160,2,6,11,111,512,263,130,284,775
Whatcom135,85,140,4,13,7,107,377,237,131,225,614
Whatcom136,72,111,5,7,5,93,376,213,110,183,589
Whatcom137,95,116,1,13,6,37,526,127,57,211,653
Whatcom138,101,190,0,2,12,65,481,123,79,291,604
Whatcom139,15,14,4,28,7,105,37,255,144,29,292
Whatcom140,36,50,12,73,7,230,157,696,322,86,853
Whatcom141,47,80,10,52,10,200,192,521,272,127,713
Whatcom142,61,103,2,34,5,107,232,288,148,164,520
Whatcom143,37,131,5,5,0,69,275,146,79,168,421
Whatcom144,25,30,17,48,9,270,104,605,344,55,709
Whatcom145,66,45,11,67,19,223,254,503,320,111,757
Whatcom146,55,98,6,39,8,237,242,505,290,153,747
Whatcom147,39,73,9,17,7,175,234,387,208,112,621
Whatcom148,52,122,8,20,6,201,252,362,235,174,614
Whatcom149,34,50,8,27,8,116,164,301,159,84,465
Whatcom150,65,74,9,36,11,195,249,426,251,139,675
Whatcom151,63,83,14,26,7,161,289,409,208,146,698
Whatcom152,65,67,5,20,9,137,282,325,171,132,607
Whatcom153,55,88,6,43,3,137,249,353,189,143,602
Whatcom154,34,82,5,4,3,109,204,207,121,116,411
Whatcom155,36,45,8,26,12,106,170,248,152,81,418
Whatcom156,32,59,1,13,7,59,133,144,80,91,277
Whatcom157,30,31,1,14,3,41,107,116,59,61,223
Whatcom158,29,49,3,15,5,82,132,171,105,78,303
Whatcom159,25,21,1,7,2,40,116,88,50,46,204
Whatcom160,82,130,10,19,16,70,479,213,115,212,692
Whatcom161,56,72,3,13,12,48,294,145,76,128,439
Whatcom162,53,77,6,11,12,77,322,211,106,130,533
Whatcom163,60,131,1,22,5,102,353,207,130,191,560
Whatcom164,16,48,0,17,3,48,117,98,68,64,215
Whatcom165,29,50,9,18,12,58,149,183,97,79,332
Whatcom166,68,147,9,13,5,126,387,292,153,215,679
Whatcom167,5,25,0,3,2,18,50,57,23,30,107
Whatcom168,114,78,5,9,25,135,451,309,174,192,760
Whatcom169,147,178,9,22,14,115,628,263,160,325,891
Whatcom170,54,71,2,25,8,46,286,138,81,125,424
Whatcom171,119,135,0,10,11,85,530,192,106,254,722
Whatcom172,57,87,1,17,4,53,268,148,75,144,416
Whatcom173,86,66,9,13,15,61,334,170,98,152,504
Whatcom174,62,114,7,21,7,66,397,180,101,176,577
Whatcom175,105,183,5,12,12,67,517,198,96,288,715
Whatcom176,108,87,1,14,16,96,350,176,127,195,526
Whatcom177,85,82,0,6,11,78,325,153,95,167,478
Whatcom178,109,167,5,15,5,70,535,196,95,276,731
Whatcom179,22,33,2,10,1,39,74,82,52,55,156
Whatcom180,116,103,3,15,12,61,403,136,91,219,539
Whatcom181,113,139,2,12,12,97,541,286,123,252,827
Whatcom182,115,171,6,15,13,150,470,386,184,286,856
Whatcom183,3,8,0,0,0,0,22,13,0,11,35
Whatcom201,193,191,5,19,26,173,665,337,223,384,1002
Whatcom202,109,85,6,13,13,66,316,146,98,194,462
Whatcom203,98,146,11,20,20,114,460,268,165,244,728
Whatcom204,54,90,2,9,4,68,286,146,83,144,432
Whatcom205,66,95,4,12,5,71,317,153,92,161,470
Whatcom206,86,193,5,15,11,75,602,192,106,279,794
Whatcom207,50,107,5,4,5,36,295,98,50,157,393
Whatcom208,140,233,6,13,4,75,789,198,98,373,987
Whatcom209,92,157,2,10,2,42,500,121,56,249,621
Whatcom210,107,232,3,11,2,24,647,62,40,339,709
Whatcom211,97,143,4,6,9,130,426,264,149,240,690
Whatcom212,61,81,2,11,9,63,346,180,85,142,526
Whatcom213,124,177,2,18,17,89,600,208,126,301,808
Whatcom214,97,146,1,5,5,36,476,82,47,243,558
Whatcom215,79,220,0,5,11,19,598,69,35,299,667
Whatcom216,95,202,2,9,2,34,521,80,47,297,601
Whatcom217,72,62,6,10,7,80,277,186,103,134,463
Whatcom218,84,89,1,19,7,60,368,141,87,173,509
Whatcom219,73,168,3,17,6,53,427,150,79,241,577
Whatcom220,87,146,2,10,6,78,490,186,96,233,676
Whatcom221,101,82,5,12,17,110,391,235,144,183,626
Whatcom222,126,187,3,5,5,47,680,124,60,313,804
Whatcom223,57,142,3,1,0,20,379,50,24,199,429
Whatcom224,53,96,1,2,1,14,254,33,18,149,287
Whatcom225,116,305,0,11,8,54,850,130,73,421,980
Whatcom226,39,138,0,2,2,17,498,45,21,177,543
Whatcom227,86,217,0,5,7,37,598,110,49,303,708
Whatcom228,59,230,2,1,1,15,678,54,19,289,732
Whatcom229,88,213,5,9,4,48,602,125,66,301,727
Whatcom230,51,179,2,2,5,37,426,103,46,230,529
Whatcom231,74,221,4,7,3,68,622,162,82,295,784
Whatcom232,113,118,2,5,17,90,443,232,114,231,675
Whatcom233,81,157,5,15,5,52,464,149,77,238,613
Whatcom234,108,143,1,19,17,99,463,195,136,251,658
Whatcom235,62,69,1,4,15,38,252,113,58,131,365
Whatcom236,47,42,0,7,5,28,193,91,40,89,284
Whatcom237,56,82,1,6,13,36,310,119,56,138,429
Whatcom238,79,73,4,12,15,70,305,176,101,152,481
Whatcom239,125,138,7,11,15,87,561,198,120,263,759
Whatcom240,118,136,2,6,16,80,503,162,104,254,665
Whatcom241,75,127,3,8,5,68,370,151,84,202,521
Whatcom242,73,112,2,3,9,25,321,84,39,185,405
Whatcom243,107,137,2,12,6,60,431,157,80,244,588
Whatcom244,129,184,2,3,10,38,591,96,53,313,687
Whatcom245,19,177,0,0,0,0,579,54,0,196,633
Whatcom246,71,193,0,4,1,23,587,66,28,264,653
Whatcom247,42,229,0,4,3,15,612,50,22,271,662
Whatcom248,62,127,4,11,10,69,475,141,94,189,616
Whatcom249,107,160,2,12,19,88,554,196,121,267,750
Whatcom250,219,182,0,10,15,49,715,128,74,401,843
Whatcom251,134,114,1,6,4,37,495,93,48,248,588
Whatcom252,8,88,0,0,2,2,270,14,4,96,284
Whatcom253,43,272,3,2,4,25,836,102,34,315,938
Whatcom254,74,96,2,16,6,42,403,127,66,170,530
Whatcom255,61,108,1,12,8,29,410,86,50,169,496
Whatcom256,128,174,1,7,9,36,550,86,53,302,636
Whatcom257,45,182,0,2,2,8,569,34,12,227,603
Whatcom258,105,245,1,1,5,18,711,55,25,350,766
Whatcom259,86,70,3,8,7,34,315,90,52,156,405
Whatcom260,81,101,3,11,9,66,332,150,89,182,482
Whatcom261,103,111,1,4,7,57,376,103,69,214,479
Whatcom262,97,157,5,6,5,31,528,90,47,254,618
Whatcom263,87,175,4,7,3,34,643,85,48,262,728
Whatcom264,132,102,4,7,16,67,464,159,94,234,623
Whatcom265,93,96,7,12,10,62,341,132,91,189,473
Whatcom266,109,123,6,10,10,76,489,150,102,232,639
Whatcom267,0,0,0,0,0,0,64,9,0,0,73
Whatcom268,0,0,0,0,0,0,18,14,0,0,32
Whatcom269,15,14,2,0,0,12,85,17,14,29,102
Whatcom301,76,105,7,35,10,150,326,366,202,181,692
Whatcom302,103,161,6,21,7,169,455,351,203,264,806
Whatcom303,128,61,7,19,24,178,368,343,228,189,711
Whatcom304,37,43,0,9,2,38,126,94,49,80,220
Whatcom401,32,49,4,29,5,116,157,254,154,81,411
Whatcom402,33,78,8,31,5,89,204,289,133,111,493
Whatcom501,61,90,5,18,16,125,310,283,164,151,593
Whatcom502,44,94,7,13,6,109,266,267,135,138,533
Whatcom503,73,107,10,20,11,113,302,329,154,180,631
Whatcom504,31,53,5,11,4,84,151,170,104,84,321
Whatcom505,102,164,13,27,13,127,459,361,180,266,820
Whatcom506,85,126,4,24,10,119,343,297,157,211,640
Whatcom507,55,89,16,11,16,108,262,243,151,144,505
Whatcom508,85,109,8,33,8,149,306,343,198,194,649
Whatcom509,57,61,5,12,10,118,217,309,145,118,526
Whatcom601,84,57,25,71,34,308,271,612,438,141,883
Whatcom602,54,47,10,43,23,209,194,486,285,101,680
Whatcom603,30,52,15,35,14,137,169,374,201,82,543
Whatcom604,44,48,19,57,20,253,187,589,349,92,776
Whatcom605,23,28,9,18,5,117,93,300,149,51,393
Whatcom606,46,32,10,34,26,222,174,464,292,78,638
Whatcom607,35,33,19,42,19,147,117,386,227,68,503
Whatcom608,43,56,17,54,21,166,168,390,258,99,558
Whatcom609,41,50,19,40,19,229,168,536,307,91,704
Whatcom610,42,51,14,70,26,272,175,550,382,93,725
Whatcom611,21,40,9,59,15,153,93,367,236,61,460
Whatcom701,42,63,20,29,9,145,191,399,203,105,590
Whatcom801,51,50,7,36,6,143,179,329,192,101,508
Whitman101,3,6,0,1,7,21,8,56,29,9,64
Whitman102,4,7,2,10,4,44,28,96,60,11,124
Whitman103,2,5,2,3,0,11,15,31,16,7,46
Whitman104,8,12,2,9,10,43,30,110,64,20,140
Whitman105,10,12,9,6,1,39,33,86,55,22,119
Whitman106,29,16,10,8,4,64,73,144,86,45,217
Whitman107,75,74,6,23,5,90,249,232,124,149,481
Whitman108,6,11,1,5,4,38,46,96,48,17,142
Whitman109,0,0,1,7,1,19,12,52,28,0,64
Whitman110,55,47,8,22,15,137,204,338,182,102,542
Whitman111,26,27,2,11,7,38,85,91,58,53,176
Whitman112,18,25,0,8,4,18,71,64,30,43,135
Whitman113,30,56,1,6,5,30,201,72,42,86,273
Whitman114,0,0,0,0,0,0,73,24,0,0,97
Whitman115,4,9,0,0,0,0,57,24,0,13,81
Whitman116,127,117,13,22,18,100,601,284,153,244,885
Whitman117,40,39,5,8,10,28,173,99,51,79,272
Whitman118,111,68,1,8,17,56,345,139,82,179,484
Whitman119,82,94,4,11,11,34,354,92,60,176,446
Whitman120,132,171,20,30,31,126,691,358,207,303,1049
Whitman121,50,53,3,12,9,27,191,89,51,103,280
Whitman122,42,54,1,4,4,22,245,55,31,96,300
Whitman123,79,100,5,5,12,20,323,93,42,179,416
Whitman124,10,29,0,0,0,0,99,25,0,39,124
Whitman125,5,18,0,0,2,3,77,23,5,23,100
Whitman126,14,16,0,0,0,0,89,22,0,30,111
Whitman127,9,24,1,0,2,4,91,14,7,33,105
Whitman128,11,50,2,0,1,8,225,46,11,61,271
Whitman129,15,60,0,5,6,7,274,45,18,75,319
Whitman130,22,19,0,0,0,0,105,28,0,41,133
Whitman131,0,0,0,0,0,0,37,9,0,0,46
Whitman132,0,0,0,0,0,0,14,0,0,0,14
Whitman133,0,0,0,0,0,0,9,2,0,0,11
Whitman134,9,27,0,0,0,0,84,25,0,36,109
Whitman135,80,78,4,7,3,36,335,94,50,158,429
Whitman136,13,14,5,9,8,48,44,136,70,27,180
Whitman137,15,16,6,9,7,92,69,248,114,31,317
Whitman138,9,8,11,7,5,41,21,148,64,17,169
Whitman139,15,20,9,12,4,89,73,229,114,35,302
Whitman140,21,29,16,20,6,81,76,219,123,50,295
Whitman141,19,21,8,6,6,76,69,217,96,40,286
Whitman142,21,41,10,29,10,111,127,286,160,62,413
Whitman143,0,0,2,9,7,12,0,0,30,0,0
Whitman144,0,0,0,2,0,13,0,0,15,0,0
Whitman145,0,0,0,2,3,2,0,23,7,0,23
Whitman146,5,5,7,8,2,34,13,83,51,10,96
Whitman147,5,8,4,6,1,51,22,110,62,13,132
Whitman148,0,0,1,3,1,24,4,61,29,0,65
Whitman149,13,22,11,19,11,102,47,230,143,35,277
Whitman150,0,0,0,0,0,0,2,14,0,0,16
Whitman151,8,5,0,6,4,34,9,78,44,13,87
Whitman152,0,0,3,4,2,26,20,69,35,0,89
Whitman218,112,90,10,19,17,69,508,232,115,202,740
Whitman228,0,0,0,0,0,0,162,20,0,0,182
Whitman234,15,37,1,4,4,10,136,40,19,52,176
Whitman235,116,99,7,8,19,71,451,173,105,215,624
Whitman31,23,31,3,15,15,94,86,231,127,54,317
Whitman32,20,12,4,8,9,57,51,146,78,32,197
Whitman33,10,10,1,1,2,20,24,48,24,20,72
Whitman34,22,28,5,15,5,50,92,158,75,50,250
Whitman35,23,15,6,15,11,46,69,145,78,38,214
Whitman36,16,28,4,8,4,37,68,92,53,44,160
Whitman37,25,42,4,4,3,38,115,107,49,67,222
Whitman42,17,7,3,5,2,51,38,124,61,24,162
Whitman43,9,14,1,6,3,44,41,109,54,23,150
Whitman44,0,0,0,0,0,0,4,21,0,0,25
Whitman45,24,15,8,8,9,109,52,215,134,39,267
Whitman46,8,11,2,2,0,23,22,55,27,19,77
Whitman47,16,29,7,15,2,97,78,202,121,45,280
Yakima1,0,0,0,0,0,0,0,0,0,0,0
Yakima101,63,30,1,5,4,44,146,96,54,93,242
Yakima102,25,26,0,0,0,0,98,34,0,51,132
Yakima103,47,43,0,0,0,0,207,66,0,90,273
Yakima104,18,21,0,0,0,0,85,21,0,39,106
Yakima105,40,26,0,2,3,34,158,61,39,66,219
Yakima110,70,66,3,12,11,96,288,221,122,136,509
Yakima1101,58,47,1,12,4,128,238,375,145,105,613
Yakima1103,51,30,1,9,8,127,221,315,145,81,536
Yakima111,70,49,4,8,10,134,216,279,156,119,495
Yakima112,17,25,2,1,0,12,112,62,15,42,174
Yakima113,72,87,0,5,0,47,362,133,52,159,495
Yakima116,45,46,2,7,8,58,205,144,75,91,349
Yakima118,31,27,2,5,4,38,116,100,49,58,216
Yakima120,67,80,0,0,0,0,367,83,0,147,450
Yakima123,14,14,1,5,0,13,97,31,19,28,128
Yakima124,29,31,0,0,0,0,185,80,0,60,265
Yakima126,72,47,0,0,2,31,328,85,33,119,413
Yakima127,81,71,3,10,0,73,342,220,86,152,562
Yakima129,60,41,5,4,3,50,201,153,62,101,354
Yakima130,78,112,6,22,11,122,378,339,161,190,717
Yakima1301,37,25,5,3,6,88,96,218,102,62,314
Yakima132,43,43,1,5,10,59,176,152,75,86,328
Yakima133,98,92,4,18,9,147,463,432,178,190,895
Yakima134,106,61,8,14,22,202,364,434,246,167,798
Yakima135,61,56,8,13,5,80,235,223,106,117,458
Yakima138,120,86,13,16,28,169,393,395,226,206,788
Yakima139,100,50,14,21,14,192,303,378,241,150,681
Yakima140,53,82,3,11,5,109,314,287,128,135,601
Yakima142,48,23,2,7,14,108,140,208,131,71,348
Yakima143,31,23,1,4,0,34,128,82,39,54,210
Yakima144,0,0,0,0,0,0,0,0,0,0,0
Yakima145,60,58,4,6,1,68,291,160,79,118,451
Yakima150,41,43,1,12,3,50,230,180,66,84,410
Yakima1501,40,40,8,16,5,103,174,325,132,80,499
Yakima1502,48,69,5,8,12,184,223,514,209,117,737
Yakima1503,41,52,13,11,13,157,199,423,194,93,622
Yakima1504,55,48,6,16,12,190,258,471,224,103,729
Yakima153,52,52,8,9,15,127,225,355,159,104,580
Yakima154,75,76,6,12,8,131,348,373,157,151,721
Yakima155,81,60,6,13,11,130,263,333,160,141,596
Yakima156,40,55,1,5,4,71,198,174,81,95,372
Yakima158,36,36,1,4,1,46,162,98,52,72,260
Yakima162,23,10,0,5,0,31,85,97,36,33,182
Yakima163,63,36,2,16,28,183,233,392,229,99,625
Yakima167,71,56,3,22,32,148,256,412,205,127,668
Yakima168,81,43,10,10,14,144,233,342,178,124,575
Yakima169,98,73,11,14,23,225,302,481,273,171,783
Yakima170,39,26,5,6,3,50,148,126,64,65,274
Yakima1701,72,64,2,5,3,40,373,118,50,136,491
Yakima1702,6,3,1,2,1,9,13,22,13,9,35
Yakima1703,56,50,6,10,7,59,217,179,82,106,396
Yakima1704,0,0,0,0,0,0,0,0,0,0,0
Yakima1705,75,38,7,14,10,106,268,257,137,113,525
Yakima1706,105,70,2,13,4,38,443,146,57,175,589
Yakima1708,60,49,2,7,1,41,333,136,51,109,469
Yakima171,27,41,3,5,7,51,116,133,66,68,249
Yakima173,51,35,12,8,13,85,199,256,118,86,455
Yakima175,36,19,2,7,4,69,120,161,82,55,281
Yakima177,62,58,12,20,18,184,248,457,234,120,705
Yakima179,74,64,8,20,25,145,270,386,198,138,656
Yakima180,29,15,4,3,8,98,126,259,113,44,385
Yakima181,78,39,10,9,12,206,244,475,237,117,719
Yakima182,98,71,14,27,20,251,328,552,312,169,880
Yakima183,61,32,4,11,26,143,190,339,184,93,529
Yakima184,75,63,4,11,5,137,297,316,157,138,613
Yakima185,52,28,11,20,14,184,228,439,229,80,667
Yakima186,90,73,15,17,15,180,330,477,227,163,807
Yakima187,54,27,4,19,9,158,218,380,190,81,598
Yakima188,81,60,14,21,23,262,351,662,320,141,1013
Yakima189,46,37,7,20,23,152,187,368,202,83,555
Yakima190,37,25,6,11,5,92,119,239,114,62,358
Yakima1901,21,21,5,7,1,59,137,119,72,42,256
Yakima191,0,0,0,0,0,0,0,0,0,0,0
Yakima2101,105,73,2,3,1,48,439,124,54,178,563
Yakima2102,86,51,2,3,3,54,353,115,62,137,468
Yakima2103,104,88,0,11,5,26,469,114,42,192,583
Yakima2301,73,58,8,4,6,82,251,209,100,131,460
Yakima2303,49,37,5,12,3,98,178,224,118,86,402
Yakima2306,63,53,7,9,7,141,270,328,164,116,598
Yakima2501,72,40,1,1,2,17,358,76,21,112,434
Yakima2502,37,40,2,2,0,8,214,22,12,77,236
Yakima2701,36,25,7,5,0,68,112,183,80,61,295
Yakima2702,59,52,12,18,8,157,223,428,195,111,651
Yakima3002,11,13,0,3,1,37,50,95,41,24,145
Yakima3004,2,2,0,0,0,0,3,15,0,4,18
Yakima301,25,28,1,3,0,11,120,38,15,53,158
Yakima302,61,59,4,11,4,66,285,147,85,120,432
Yakima303,85,50,5,5,2,69,343,138,81,135,481
Yakima304,18,17,2,0,3,25,81,82,30,35,163
Yakima305,3,2,0,0,0,0,10,5,0,5,15
Yakima306,102,55,4,10,12,80,325,237,106,157,562
Yakima307,0,0,1,0,2,6,16,26,9,0,42
Yakima308,0,0,0,0,0,0,0,0,0,0,0
Yakima3101,80,79,17,19,11,209,321,500,256,159,821
Yakima3102,57,47,3,12,2,93,306,229,110,104,535
Yakima3103,55,43,5,5,1,63,254,139,74,98,393
Yakima3104,39,42,8,12,5,121,192,264,146,81,456
Yakima3105,6,5,1,4,1,21,21,48,27,11,69
Yakima3106,25,39,4,13,9,135,146,366,161,64,512
Yakima3203,35,35,5,25,24,186,143,470,240,70,613
Yakima3204,5,6,0,2,1,21,20,50,24,11,70
Yakima3205,43,57,12,25,18,209,213,572,264,100,785
Yakima3206,50,46,6,13,12,215,213,418,246,96,631
Yakima3208,6,8,2,1,0,21,26,67,24,14,93
Yakima3301,32,23,3,18,1,120,118,297,142,55,415
Yakima3303,28,23,3,12,3,60,109,158,78,51,267
Yakima3304,46,23,6,8,11,181,169,427,206,69,596
Yakima3305,23,29,6,5,8,165,96,392,184,52,488
Yakima3306,12,17,4,3,2,114,53,229,123,29,282
Yakima3308,30,44,13,8,9,164,156,371,194,74,527
Yakima3309,61,50,1,7,7,62,250,165,77,111,415
Yakima3310,88,47,6,5,1,87,356,220,99,135,576
Yakima3311,55,57,8,28,17,233,285,617,286,112,902
Yakima3313,5,6,0,11,0,61,26,160,72,11,186
Yakima3401,27,37,0,5,2,13,208,73,20,64,281
Yakima3504,0,0,0,0,0,0,2,18,0,0,20
Yakima3601,0,0,0,7,2,12,7,37,21,0,44
Yakima3602,55,56,19,15,15,248,225,626,297,111,851
Yakima3605,24,26,12,13,6,174,114,458,205,50,572
Yakima3701,36,38,3,6,6,113,218,235,128,74,453
Yakima3900,41,35,7,18,4,190,140,478,219,76,618
Yakima3901,7,18,0,10,4,115,51,263,129,25,314
Yakima3902,30,17,2,3,0,64,126,122,69,47,248
Yakima3903,35,55,15,15,6,289,184,637,325,90,821
Yakima3904,12,8,7,4,4,43,52,129,58,20,181
Yakima3905,11,12,0,5,0,49,37,133,54,23,170
Yakima4001,20,18,1,5,2,33,141,93,41,38,234
Yakima4002,19,12,3,5,2,36,96,96,46,31,192
Yakima4003,72,58,3,10,6,254,255,549,273,130,804
Yakima4005,20,13,1,6,4,110,80,227,121,33,307
Yakima4101,20,11,2,5,4,51,70,153,62,31,223
Yakima4102,43,19,12,19,3,203,96,433,237,62,529
Yakima4104,16,32,4,9,10,92,174,267,115,48,441
Yakima4105,22,14,2,16,6,48,87,158,72,36,245
Yakima4106,30,33,7,16,8,153,130,351,184,63,481
Yakima4108,31,16,4,25,9,97,114,295,135,47,409
Yakima4109,68,65,7,30,15,137,299,387,189,133,686
Yakima4111,48,32,7,23,9,199,178,454,238,80,632
Yakima4112,64,46,5,22,15,262,227,599,304,110,826
Yakima4114,30,29,6,9,5,202,144,455,222,59,599
Yakima4115,15,19,5,12,4,89,71,208,110,34,279
Yakima4303,21,7,5,10,5,46,66,128,66,28,194
Yakima4401,34,15,5,5,10,83,94,185,103,49,279
Yakima4402,28,14,9,8,13,118,111,312,148,42,423
Yakima4501,17,10,0,0,0,0,67,109,0,27,176
Yakima4503,2,4,0,1,2,18,12,43,21,6,55
Yakima4504,45,30,2,3,12,141,129,290,158,75,419
Yakima4601,24,17,0,2,19,62,83,141,83,41,224
Yakima4602,34,23,6,12,3,69,96,194,90,57,290
Yakima4603,39,50,17,18,14,174,169,459,223,89,628
Yakima4604,18,14,3,3,6,75,69,200,87,32,269
Yakima4605,0,0,0,0,0,0,0,0,0,0,0
Yakima4606,70,53,10,15,13,186,254,402,224,123,656
Yakima4608,0,0,1,2,1,24,12,61,28,0,73
Yakima4609,13,18,3,5,8,75,52,191,91,31,243
Yakima4615,34,40,3,19,10,100,183,244,132,74,427
Yakima4616,13,3,6,10,7,73,56,147,96,16,203
Yakima4618,33,28,8,16,6,64,151,219,94,61,370
Yakima4623,5,2,2,2,0,29,19,54,33,7,73
Yakima4624,17,15,0,6,5,63,71,158,74,32,229
Yakima4625,0,0,0,0,0,0,0,0,0,0,0
Yakima4626,0,0,0,0,2,2,11,15,4,0,26
Yakima4627,18,10,4,2,8,41,58,109,55,28,167
Yakima4628,16,11,1,4,2,51,68,138,58,27,206
Yakima4801,50,53,12,30,18,320,186,666,380,103,852
Yakima4802,81,77,12,17,31,233,340,598,293,158,938
Yakima5001,19,16,2,2,3,28,73,81,35,35,154
Yakima5003,34,34,10,14,11,155,137,421,190,68,558
Yakima501,89,63,2,6,5,41,412,146,54,152,558
Yakima5010,18,5,2,4,2,44,52,105,52,23,157
Yakima5012,45,60,7,3,2,80,266,214,92,105,480
Yakima5014,36,19,6,24,7,167,132,412,204,55,544
Yakima5016,21,28,2,5,6,99,78,228,112,49,306
Yakima5020,26,11,6,15,12,100,95,240,133,37,335
Yakima5101,19,26,0,6,5,72,91,176,83,45,267
Yakima5202,0,0,0,0,0,0,0,0,0,0,0
Yakima701,26,25,10,3,2,22,97,53,37,51,150
Yakima901,70,33,0,0,0,0,255,42,0,103,297
