precinct,pri_dem_CLINTON,pri_dem_SANDERS,gen_con_CASTLE,gen_dem_CLINTON,gen_ind_FUENTE,gen_lib_JOHNSON,gen_rep_TRUMP,dem_primary_total,general_total
CARSON CITY101,3,4,5,354,3,39,419,7,820
CARSON CITY103,4,3,6,392,1,25,476,7,900
CARSON CITY105,3,2,8,375,1,39,608,5,1031
CARSON CITY107,3,3,8,376,1,39,617,6,1041
CARSON CITY109,4,4,11,482,0,47,606,8,1146
CARSON CITY111,3,6,4,516,5,80,528,9,1133
CARSON CITY113,4,4,5,445,3,45,783,8,1281
CARSON CITY201,3,3,4,351,2,43,410,6,810
CARSON CITY203,4,5,10,490,3,71,516,9,1090
CARSON CITY205,4,5,4,524,3,64,608,9,1203
CARSON CITY207,3,5,7,372,4,28,561,8,972
CARSON CITY209,2,3,7,293,3,47,377,5,727
CARSON CITY211,2,2,3,258,1,45,464,4,771
CARSON CITY301,3,3,5,334,6,36,454,6,835
CARSON CITY303,3,3,2,298,1,42,477,6,820
CARSON CITY305,4,3,4,386,1,45,606,7,1042
CARSON CITY307,6,5,13,715,1,82,688,11,1499
CARSON CITY309,5,2,9,399,4,48,830,7,1290
CARSON CITY401,3,3,4,353,3,51,381,6,792
CARSON CITY403,5,5,11,523,4,74,672,10,1284
CARSON CITY405,4,4,5,431,1,38,556,8,1031
CARSON CITY407,3,2,6,274,3,39,574,5,896
CARSON CITY409,3,5,7,464,5,62,480,8,1018
CARSON CITY411,2,2,5,193,1,30,425,4,654
CHURCHILL10,3,3,4,138,1,32,594,6,769
CHURCHILL11,3,3,9,140,1,37,605,6,792
CHURCHILL12,0,2,4,52,1,13,216,2,286
CHURCHILL13,1,1,3,52,2,15,355,2,427
CHURCHILL14,1,2,7,88,1,18,414,3,528
CHURCHILL15,2,2,3,91,1,21,479,4,595
CHURCHILL16,2,4,6,128,1,16,242,6,393
CHURCHILL17,2,5,11,148,1,37,688,7,885
CHURCHILL18,5,3,1,208,2,31,736,8,978
CHURCHILL19,2,1,11,93,0,12,391,3,507
CLARK1038,2,1,0,151,0,2,199,3,352
CLARK1039,3,2,0,293,1,11,557,5,862
CLARK1063,5,5,3,467,1,39,470,10,980
CLARK1067,1,0,1,19,1,3,90,1,114
CLARK1072,1,1,1,60,0,14,142,2,217
CLARK1074,7,4,7,430,1,22,744,11,1204
CLARK1137,5,4,4,431,1,32,398,9,866
CLARK1302,7,6,2,690,4,45,446,13,1187
CLARK1303,5,6,3,527,1,30,395,11,956
CLARK1304,3,4,4,362,1,27,219,7,613
CLARK1307,6,6,6,679,3,37,554,12,1279
CLARK1318,5,6,4,620,0,33,304,11,961
CLARK1327,7,8,2,744,6,55,414,15,1221
CLARK1328,5,6,4,616,5,28,355,11,1008
CLARK1330,6,7,1,595,0,34,667,13,1297
CLARK1331,6,9,2,586,3,29,406,15,1026
CLARK1332,2,3,2,262,1,11,188,5,464
CLARK1333,6,3,3,432,2,22,425,9,884
CLARK1334,5,7,3,622,2,33,477,12,1137
CLARK1335,6,5,5,566,4,34,504,11,1113
CLARK1336,3,5,4,428,1,22,305,8,760
CLARK1337,8,6,6,645,3,35,449,14,1138
CLARK1340,6,9,3,744,3,50,417,15,1217
CLARK1341,5,7,4,590,5,42,392,12,1033
CLARK1342,5,4,1,462,2,36,359,9,860
CLARK1343,2,4,2,296,0,18,390,6,706
CLARK1344,2,4,0,282,0,14,216,6,512
CLARK1345,3,2,4,275,1,17,195,5,492
CLARK1346,5,5,3,494,4,28,541,10,1070
CLARK1348,4,7,4,557,4,25,411,11,1001
CLARK1349,4,7,0,570,5,47,337,11,959
CLARK1351,5,7,2,577,2,29,291,12,901
CLARK1352,5,6,11,500,3,27,346,11,887
CLARK1353,4,10,8,699,0,35,396,14,1138
CLARK1354,4,3,3,349,0,24,216,7,592
CLARK1356,7,6,7,644,1,30,426,13,1108
CLARK1365,0,0,0,0,0,0,0,0,0
CLARK1367,7,8,7,753,5,50,443,15,1258
CLARK1368,4,11,6,706,3,57,445,15,1217
CLARK1371,0,0,0,0,0,0,0,0,0
CLARK1374,0,0,0,0,0,0,0,0,0
CLARK1377,0,0,0,0,0,0,0,0,0
CLARK1381,0,0,0,0,0,0,0,0,0
CLARK1384,0,1,2,130,0,7,116,1,255
CLARK1386,0,0,0,0,0,0,0,0,0
CLARK1389,4,3,4,401,0,19,349,7,773
CLARK1390,8,8,9,787,4,41,650,16,1491
CLARK1391,6,5,6,644,0,52,503,11,1205
CLARK1394,4,4,5,440,1,32,591,8,1069
CLARK1395,4,3,5,374,0,24,599,7,1002
CLARK1396,6,3,2,455,0,18,364,9,839
CLARK1410,6,5,3,554,0,59,635,11,1251
CLARK1411,5,4,4,464,3,19,519,9,1009
CLARK1509,5,3,4,426,1,26,624,8,1081
CLARK1510,3,2,1,265,1,8,527,5,802
CLARK1511,4,3,2,396,1,26,481,7,906
CLARK1513,6,3,3,531,1,33,758,9,1326
CLARK1514,4,5,3,471,2,39,620,9,1135
CLARK1517,5,1,0,300,0,6,396,6,702
CLARK1518,6,2,1,505,1,27,746,8,1280
CLARK1519,2,0,0,141,0,9,311,2,461
CLARK1520,4,1,2,260,2,8,367,5,639
CLARK1521,5,1,0,314,1,21,598,6,934
CLARK1525,7,2,0,523,0,12,830,9,1365
CLARK1528,6,4,1,594,0,52,858,10,1505
CLARK1550,3,3,1,310,1,20,404,6,736
CLARK1552,2,3,0,287,3,14,327,5,631
CLARK1601,5,5,3,421,0,21,297,10,742
CLARK1602,4,4,4,440,3,15,208,8,670
CLARK1603,3,3,0,424,3,10,200,6,637
CLARK1604,4,5,3,413,2,12,328,9,758
CLARK1605,4,6,1,470,2,24,268,10,765
CLARK1606,2,1,0,174,1,13,235,3,423
CLARK1607,1,0,0,49,2,3,34,1,88
CLARK1608,5,2,2,428,2,26,638,7,1096
CLARK1609,4,8,6,674,2,49,451,12,1182
CLARK1611,7,7,3,602,3,22,277,14,907
CLARK1612,6,6,8,629,1,28,591,12,1257
CLARK1613,5,3,1,386,1,25,248,8,661
CLARK1614,5,4,1,385,0,26,315,9,727
CLARK1615,5,5,4,446,2,19,319,10,790
CLARK1616,4,4,1,327,2,17,241,8,588
CLARK1617,6,5,5,457,2,17,285,11,766
CLARK1618,5,5,4,515,1,25,376,10,921
CLARK1619,9,5,1,737,1,24,549,14,1312
CLARK1621,4,6,4,441,4,28,264,10,741
CLARK1623,1,3,2,201,0,13,142,4,358
CLARK1624,0,0,1,238,1,23,201,0,464
CLARK1625,3,5,3,367,2,22,280,8,674
CLARK1631,6,7,1,581,2,27,357,13,968
CLARK1632,4,4,2,339,1,26,197,8,565
CLARK1633,9,8,5,678,3,17,328,17,1031
CLARK1634,4,8,5,478,5,17,184,12,689
CLARK1635,3,5,0,352,3,16,129,8,500
CLARK1641,4,6,3,388,2,13,251,10,657
CLARK1642,4,4,3,307,1,11,130,8,452
CLARK1643,1,1,3,170,0,10,171,2,354
CLARK1644,1,0,0,0,0,0,0,1,0
CLARK1645,1,1,0,78,0,6,51,2,135
CLARK1651,2,1,0,131,0,12,312,3,455
CLARK1652,8,9,5,790,5,33,393,17,1226
CLARK1653,9,7,5,723,6,22,273,16,1029
CLARK1655,7,8,4,685,0,27,296,15,1012
CLARK1661,7,6,6,570,2,24,301,13,903
CLARK1662,5,6,2,487,5,23,293,11,810
CLARK1664,4,3,1,306,0,16,368,7,691
CLARK1665,1,0,0,0,0,0,0,1,0
CLARK1668,6,4,5,596,1,31,766,10,1399
CLARK1669,3,1,1,230,0,15,243,4,489
CLARK1670,6,5,3,502,4,30,387,11,926
CLARK1671,0,0,0,4,0,1,14,0,19
CLARK1672,4,4,2,457,1,31,365,8,856
CLARK1674,6,1,0,311,1,9,469,7,790
CLARK1675,5,3,2,409,0,31,558,8,1000
CLARK1676,3,2,0,199,2,12,287,5,500
CLARK1677,6,4,1,416,0,35,402,10,854
CLARK1678,5,3,2,334,0,22,479,8,837
CLARK1679,5,4,8,425,4,42,475,9,954
CLARK1680,7,6,7,650,0,46,618,13,1321
CLARK1681,1,0,0,9,0,1,33,1,43
CLARK1682,5,7,11,565,3,35,351,12,965
CLARK1683,4,9,5,602,2,33,421,13,1063
CLARK1684,1,2,2,133,0,6,194,3,335
CLARK1685,0,0,0,0,0,0,0,0,0
CLARK1686,3,3,1,306,1,36,452,6,796
CLARK1687,4,6,3,508,0,45,418,10,974
CLARK1688,6,3,0,411,1,27,348,9,787
CLARK1689,6,3,2,385,1,6,360,9,754
CLARK1692,1,0,0,39,0,1,117,1,157
CLARK1693,2,1,3,138,3,9,270,3,423
CLARK1695,2,3,0,299,0,14,164,5,477
CLARK1702,3,6,4,498,2,46,430,9,980
CLARK1703,7,6,2,657,2,38,332,13,1031
CLARK1704,4,4,6,365,0,19,345,8,735
CLARK1712,9,5,7,1037,3,57,1190,14,2294
CLARK1715,6,0,1,313,0,4,566,6,884
CLARK1717,6,1,0,420,0,5,589,7,1014
CLARK1718,8,2,3,563,1,16,753,10,1336
CLARK1719,6,1,0,412,0,11,540,7,963
CLARK1720,6,2,1,348,0,8,420,8,777
CLARK1721,6,2,1,401,4,12,635,8,1053
CLARK1722,5,0,1,266,1,12,378,5,658
CLARK1727,8,6,6,773,0,33,987,14,1799
CLARK1732,0,1,1,50,0,3,24,1,78
CLARK1750,4,2,3,264,3,20,457,6,747
CLARK1751,4,1,1,227,0,16,658,5,902
CLARK1753,1,0,0,39,1,0,108,1,148
CLARK2008,6,5,2,454,4,27,548,11,1035
CLARK2037,7,4,4,461,2,28,497,11,992
CLARK2044,4,7,3,472,7,30,644,11,1156
CLARK2126,4,2,6,215,2,11,167,6,401
CLARK2352,4,3,7,319,4,22,413,7,765
CLARK2353,8,0,1,364,0,17,567,8,949
CLARK2354,5,2,2,337,0,18,307,7,664
CLARK2360,9,8,6,781,6,24,332,17,1149
CLARK2366,8,6,5,617,4,36,449,14,1111
CLARK2371,4,6,6,463,2,22,360,10,853
CLARK2372,7,7,6,577,0,41,320,14,944
CLARK2373,5,3,1,362,2,20,291,8,676
CLARK2380,8,7,3,627,5,24,288,15,947
CLARK2381,11,6,6,734,4,33,350,17,1127
CLARK2382,8,10,7,824,3,48,373,18,1255
CLARK2383,10,7,10,721,2,30,473,17,1236
CLARK2384,6,8,7,625,4,58,527,14,1221
CLARK2385,6,4,2,498,5,26,368,10,899
CLARK2386,11,4,7,644,2,22,490,15,1165
CLARK2387,8,8,8,832,4,44,499,16,1387
CLARK2390,8,6,1,646,3,32,409,14,1091
CLARK2391,5,2,6,308,2,16,326,7,658
CLARK2392,7,4,9,489,1,28,299,11,826
CLARK2393,9,7,6,698,2,46,467,16,1219
CLARK2394,11,6,6,849,3,37,410,17,1305
CLARK2400,12,8,6,953,5,41,354,20,1359
CLARK2401,0,0,0,0,0,0,0,0,0
CLARK2405,0,0,0,0,0,0,0,0,0
CLARK2406,0,0,0,0,0,0,0,0,0
CLARK2407,0,0,0,0,0,0,0,0,0
CLARK2408,0,0,0,0,0,0,0,0,0
CLARK2409,10,7,8,872,2,40,463,17,1385
CLARK2417,1,3,2,103,2,12,82,4,201
CLARK2430,9,9,7,587,5,23,259,18,881
CLARK2440,10,2,1,573,0,14,733,12,1321
CLARK2444,2,1,1,141,1,5,120,3,268
CLARK2446,12,6,9,1021,5,66,597,18,1698
CLARK2449,9,5,2,729,4,48,508,14,1291
CLARK2456,7,4,6,563,4,20,334,11,927
CLARK2457,9,6,14,751,1,80,829,15,1675
CLARK2463,11,11,13,1027,8,47,366,22,1461
CLARK2464,11,6,12,1066,6,46,789,17,1919
CLARK2465,4,3,9,244,1,28,632,7,914
CLARK2466,6,3,2,408,0,17,722,9,1149
CLARK2469,3,0,1,84,1,7,267,3,360
CLARK2473,1,1,8,54,0,14,332,2,408
CLARK2476,2,2,13,115,0,25,1014,4,1167
CLARK2477,2,1,2,180,0,8,444,3,634
CLARK2479,9,7,1,771,2,50,534,16,1358
CLARK2480,9,6,3,680,1,52,576,15,1312
CLARK2481,9,11,4,919,0,43,356,20,1322
CLARK2483,13,7,4,925,4,49,338,20,1320
CLARK2484,7,6,1,642,4,38,415,13,1100
CLARK2500,8,2,1,502,1,11,595,10,1110
CLARK2501,0,1,0,4,0,2,20,1,26
CLARK2503,0,0,0,4,0,1,7,0,12
CLARK2600,5,4,5,475,1,46,589,9,1116
CLARK2601,0,0,0,9,0,0,7,0,16
CLARK2602,0,1,0,44,0,5,70,1,119
CLARK2603,6,3,10,441,1,56,582,9,1090
CLARK2604,3,5,5,368,2,38,410,8,823
CLARK2605,4,5,5,391,2,26,540,9,964
CLARK2606,7,5,3,519,2,31,333,12,888
CLARK2607,9,5,3,633,1,11,287,14,935
CLARK2609,0,0,0,0,0,0,0,0,0
CLARK2611,5,7,6,610,3,46,592,12,1257
CLARK2613,4,6,8,457,1,42,494,10,1002
CLARK2614,4,5,3,373,4,23,483,9,886
CLARK2615,4,4,4,406,2,47,565,8,1024
CLARK2616,5,2,1,357,0,23,179,7,560
CLARK2617,6,3,5,386,0,23,267,9,681
CLARK2621,6,5,7,546,4,56,547,11,1160
CLARK2622,5,2,8,334,0,24,419,7,785
CLARK2624,3,2,4,236,1,21,406,5,668
CLARK2631,0,1,0,5,0,0,14,1,19
CLARK2632,0,1,2,5,0,0,25,1,32
CLARK2633,2,3,3,222,0,35,602,5,862
CLARK2634,3,3,8,250,1,29,366,6,654
CLARK2635,6,3,1,491,0,36,625,9,1153
CLARK2641,1,0,0,8,0,0,3,1,11
CLARK2642,1,0,0,17,0,3,37,1,57
CLARK2643,7,2,11,505,1,24,783,9,1324
CLARK2644,4,3,4,307,1,26,649,7,987
CLARK2645,1,0,0,38,0,3,74,1,115
CLARK2650,5,2,4,317,0,28,489,7,838
CLARK2651,3,1,2,195,1,11,312,4,521
CLARK2652,7,6,5,630,4,52,598,13,1289
CLARK2653,4,4,6,371,6,30,766,8,1179
CLARK2654,4,3,2,296,0,24,377,7,699
CLARK2655,6,1,3,300,0,24,518,7,845
CLARK2660,3,2,2,257,3,27,350,5,639
CLARK2661,7,5,5,562,2,42,710,12,1321
CLARK2662,1,1,2,93,1,5,117,2,218
CLARK2663,3,2,3,226,3,22,558,5,812
CLARK2664,0,0,0,6,0,0,5,0,11
CLARK2665,0,1,0,33,0,1,110,1,144
CLARK2666,9,7,5,887,5,45,639,16,1581
CLARK2671,7,3,15,475,2,44,858,10,1394
CLARK2672,6,4,7,461,5,37,691,10,1201
CLARK2673,1,0,1,38,0,4,72,1,115
CLARK2674,8,8,4,680,3,48,463,16,1198
CLARK2675,0,0,0,4,0,1,17,0,22
CLARK2676,1,0,1,8,0,0,18,1,27
CLARK2681,1,0,0,0,0,0,0,1,0
CLARK2682,3,3,0,357,1,18,449,6,825
CLARK2683,0,0,0,0,0,0,0,0,0
CLARK2684,1,0,0,8,0,1,13,1,22
CLARK2685,0,0,0,0,0,0,0,0,0
CLARK2691,0,0,0,9,0,0,21,0,30
CLARK2692,5,4,4,406,2,26,541,9,979
CLARK2693,0,1,0,32,0,1,58,1,91
CLARK2695,5,3,2,360,3,26,567,8,958
CLARK2696,0,1,0,20,0,0,19,1,39
CLARK2700,5,4,5,397,0,21,362,9,785
CLARK2701,7,4,7,478,5,43,605,11,1138
CLARK2702,5,3,1,356,1,21,311,8,690
CLARK2703,0,0,0,0,0,0,0,0,0
CLARK2704,0,0,0,8,0,0,23,0,31
CLARK2705,6,3,2,402,0,25,403,9,832
CLARK2706,0,0,0,0,0,0,0,0,0
CLARK2709,3,3,0,278,2,20,304,6,604
CLARK2710,2,5,2,309,1,31,289,7,632
CLARK2711,6,4,4,420,5,21,451,10,901
CLARK2713,6,2,4,407,4,18,186,8,619
CLARK2714,5,6,7,453,0,16,150,11,626
CLARK2716,9,6,10,751,1,44,321,15,1127
CLARK2722,3,2,4,189,1,14,77,5,285
CLARK2724,5,6,6,556,4,32,275,11,873
CLARK2725,1,1,8,71,3,9,386,2,477
CLARK2726,1,1,6,71,1,8,374,2,460
CLARK2727,2,3,15,168,1,25,729,5,938
CLARK2729,4,2,2,301,2,19,86,6,410
CLARK2730,10,9,13,839,7,52,316,19,1227
CLARK2731,7,4,12,529,3,26,895,11,1465
CLARK2732,5,3,6,402,1,29,514,8,952
CLARK2733,4,6,2,422,4,29,216,10,673
CLARK2734,8,4,10,551,4,25,294,12,884
CLARK2735,6,8,3,493,2,19,184,14,701
CLARK2736,3,2,2,268,0,15,164,5,449
CLARK2737,6,8,8,620,0,27,165,14,820
CLARK2738,3,6,5,424,1,22,262,9,714
CLARK2740,11,10,3,606,4,20,251,21,884
CLARK2742,5,5,4,396,1,25,187,10,613
CLARK2743,9,5,7,625,7,25,353,14,1017
CLARK2745,0,0,0,6,0,0,6,0,12
CLARK2746,6,4,5,403,1,19,244,10,672
CLARK2751,5,4,1,362,2,10,135,9,510
CLARK2752,11,10,7,837,5,18,184,21,1051
CLARK2770,1,0,0,40,0,2,10,1,52
CLARK2775,4,1,6,459,2,21,858,5,1346
CLARK2776,5,2,4,398,0,28,973,7,1403
CLARK3036,5,1,1,263,1,5,352,6,622
CLARK3037,3,2,1,230,0,5,292,5,528
CLARK3040,5,2,3,326,0,10,558,7,897
CLARK3152,1,0,0,22,0,5,37,1,64
CLARK3217,7,6,4,677,4,43,622,13,1350
CLARK3361,8,3,3,501,3,26,434,11,967
CLARK3363,6,3,1,564,0,30,697,9,1292
CLARK3364,6,2,4,502,3,20,810,8,1339
CLARK3365,3,3,0,337,0,15,355,6,707
CLARK3366,3,2,2,284,0,16,421,5,723
CLARK3370,4,3,2,350,0,17,370,7,739
CLARK3371,3,3,2,337,0,8,245,6,592
CLARK3372,5,4,0,493,2,29,466,9,990
CLARK3373,7,3,3,526,0,39,578,10,1146
CLARK3374,5,1,1,358,1,23,364,6,747
CLARK3375,6,3,3,545,4,31,601,9,1184
CLARK3380,2,3,1,270,1,15,172,5,459
CLARK3381,7,4,5,602,2,49,665,11,1323
CLARK3382,7,3,1,507,0,44,458,10,1010
CLARK3383,5,1,1,347,0,13,647,6,1008
CLARK3385,6,4,5,623,2,32,730,10,1392
CLARK3386,3,2,3,318,1,10,355,5,687
CLARK3391,3,3,0,332,1,24,279,6,636
CLARK3392,5,3,3,355,1,21,329,8,709
CLARK3393,4,2,5,272,0,18,244,6,539
CLARK3395,4,3,2,357,1,12,442,7,814
CLARK3413,6,1,0,308,1,13,449,7,771
CLARK3416,4,5,5,494,1,36,476,9,1012
CLARK3417,6,6,5,751,2,63,565,12,1386
CLARK3418,3,2,1,246,0,20,281,5,548
CLARK3430,5,4,6,464,3,27,371,9,871
CLARK3431,4,5,5,446,2,23,421,9,897
CLARK3433,1,0,0,0,0,0,0,1,0
CLARK3435,6,6,12,595,4,46,463,12,1120
CLARK3457,0,0,0,0,0,0,0,0,0
CLARK3464,5,3,1,372,0,23,586,8,982
CLARK3465,5,2,2,350,3,16,404,7,775
CLARK3518,0,0,0,2,0,0,7,0,9
CLARK3532,1,1,1,54,0,6,171,2,232
CLARK3535,1,0,1,17,0,5,37,1,60
CLARK3540,2,1,1,122,0,11,245,3,379
CLARK3544,3,2,3,406,0,34,524,5,967
CLARK3546,3,6,8,589,4,49,496,9,1146
CLARK3547,7,6,2,793,5,63,959,13,1822
CLARK3557,8,4,5,752,2,39,686,12,1484
CLARK3564,1,0,1,59,0,9,198,1,267
CLARK3565,4,4,6,416,1,33,443,8,899
CLARK3576,2,2,1,233,1,17,348,4,600
CLARK3579,0,0,0,3,0,0,7,0,10
CLARK3582,0,0,0,6,0,0,4,0,10
CLARK3602,7,5,5,605,1,55,658,12,1324
CLARK3604,6,10,8,762,4,78,597,16,1449
CLARK3605,1,2,2,91,0,19,191,3,303
CLARK3606,6,3,6,422,1,20,409,9,858
CLARK3607,6,12,10,1008,3,90,649,18,1760
CLARK3608,4,2,4,322,2,25,777,6,1130
CLARK3609,4,3,6,336,2,33,684,7,1061
CLARK3610,6,3,4,380,5,37,560,9,986
CLARK3700,0,0,0,0,0,0,0,0,0
CLARK3702,7,8,7,657,1,28,544,15,1237
CLARK3703,1,0,0,8,0,0,8,1,16
CLARK3704,4,4,4,367,2,20,214,8,607
CLARK3706,7,7,10,989,6,103,980,14,2088
CLARK3707,5,6,8,803,3,60,888,11,1762
CLARK3708,2,2,2,194,1,18,223,4,438
CLARK3709,6,6,7,751,3,60,668,12,1489
CLARK3710,1,1,2,79,0,5,107,2,193
CLARK3711,1,1,2,55,0,9,138,2,204
CLARK3713,1,0,0,12,0,2,17,1,31
CLARK3715,0,1,0,52,0,6,124,1,182
CLARK3716,2,2,3,208,0,23,316,4,550
CLARK3717,1,2,1,135,1,14,330,3,481
CLARK3718,4,1,2,190,0,17,533,5,742
CLARK3719,6,5,8,545,2,38,516,11,1109
CLARK3720,3,4,1,311,2,14,224,7,552
CLARK3721,6,3,3,373,2,27,428,9,833
CLARK3722,3,4,2,303,1,19,246,7,571
CLARK3723,2,4,2,259,1,21,342,6,625
CLARK3724,5,6,5,443,2,32,348,11,830
CLARK3725,0,0,0,0,0,0,0,0,0
CLARK3726,6,6,3,622,2,41,527,12,1195
CLARK3727,7,2,3,508,1,25,666,9,1203
CLARK3728,11,0,4,494,1,13,643,11,1155
CLARK3729,3,2,2,352,0,24,376,5,754
CLARK3730,5,8,10,562,2,54,576,13,1204
CLARK3731,0,0,0,0,0,0,0,0,0
CLARK3732,2,6,2,374,0,30,219,8,625
CLARK3733,5,6,6,420,3,25,362,11,816
CLARK3734,4,4,2,513,0,34,588,8,1137
CLARK3735,0,0,0,20,0,1,25,0,46
CLARK3736,0,0,0,5,0,0,27,0,32
CLARK3738,3,0,0,111,0,5,96,3,212
CLARK3739,5,2,3,444,0,20,402,7,869
CLARK3740,1,0,0,294,0,8,323,1,625
CLARK3741,2,2,4,149,1,9,244,4,407
CLARK3742,9,6,7,575,5,31,294,15,912
CLARK3743,7,5,4,497,3,34,409,12,947
CLARK3746,5,4,2,520,1,38,664,9,1225
CLARK3747,4,4,2,393,1,21,325,8,742
CLARK3748,7,3,2,496,2,22,478,10,1000
CLARK3749,7,6,14,583,1,20,492,13,1110
CLARK3751,4,6,1,419,3,25,139,10,587
CLARK3752,6,7,2,569,5,31,208,13,815
CLARK3753,0,0,0,0,0,0,0,0,0
CLARK3754,9,10,10,835,0,41,420,19,1306
CLARK3755,3,5,2,397,2,33,259,8,693
CLARK3756,1,2,4,124,1,14,304,3,447
CLARK3757,2,2,4,210,1,16,457,4,688
CLARK3758,2,4,2,272,0,33,612,6,919
CLARK3759,6,3,8,499,2,32,612,9,1153
CLARK3760,6,6,6,585,1,44,412,12,1048
CLARK3761,4,6,4,416,3,14,274,10,711
CLARK3762,5,5,5,425,2,34,275,10,741
CLARK3764,6,8,2,642,2,34,365,14,1045
CLARK3765,6,8,9,678,1,30,404,14,1122
CLARK3766,2,3,2,259,1,11,315,5,588
CLARK3767,0,0,0,4,0,0,30,0,34
CLARK3768,4,4,0,423,3,21,329,8,776
CLARK3769,4,4,4,403,2,22,347,8,778
CLARK3770,7,4,6,525,4,33,309,11,877
CLARK3771,4,4,2,355,0,17,265,8,639
CLARK3772,5,5,3,501,1,20,324,10,849
CLARK3773,4,6,4,434,2,27,318,10,785
CLARK3774,4,5,5,359,2,27,346,9,739
CLARK3775,3,4,4,295,0,11,240,7,550
CLARK3780,7,3,3,549,2,28,595,10,1177
CLARK3782,2,2,2,184,1,21,193,4,401
CLARK3783,4,7,1,508,0,38,255,11,802
CLARK3784,5,5,3,449,0,27,248,10,727
CLARK3785,4,5,0,361,4,24,194,9,583
CLARK3786,7,6,5,605,5,43,619,13,1277
CLARK3787,5,5,2,489,1,34,500,10,1026
CLARK3788,7,2,5,454,0,9,639,9,1107
CLARK3789,7,1,1,383,1,10,513,8,908
CLARK3790,6,2,1,397,1,11,478,8,888
CLARK3791,6,5,3,477,3,23,245,11,751
CLARK3792,5,4,3,388,2,11,205,9,609
CLARK3794,7,5,4,463,1,19,195,12,682
CLARK3795,4,6,0,378,1,13,157,10,549
CLARK3796,2,1,1,108,0,3,36,3,148
CLARK3800,3,3,2,331,0,24,316,6,673
CLARK3801,5,2,2,298,0,6,96,7,402
CLARK3802,4,6,4,418,3,20,165,10,610
CLARK3803,0,0,0,21,0,1,16,0,38
CLARK3804,5,9,1,580,3,19,293,14,896
CLARK3805,0,0,1,54,0,1,25,0,81
CLARK3806,3,2,0,242,1,25,209,5,477
CLARK3807,5,4,5,488,0,40,540,9,1073
CLARK3808,5,2,1,366,0,17,412,7,796
CLARK3809,4,4,5,429,5,35,351,8,825
CLARK3811,7,9,3,643,2,22,192,16,862
CLARK3812,2,1,1,107,0,5,59,3,172
CLARK3813,8,5,4,609,4,22,215,13,854
CLARK3814,5,3,2,364,2,11,216,8,595
CLARK3815,5,7,7,390,2,20,187,12,606
CLARK3822,0,1,0,14,0,1,24,1,39
CLARK3823,0,0,0,12,0,0,0,0,12
CLARK3824,1,3,1,160,1,10,90,4,262
CLARK3825,0,0,0,0,0,0,0,0,0
CLARK3826,1,2,3,158,0,10,164,3,335
CLARK3831,0,0,3,35,0,5,37,0,80
CLARK3832,0,0,0,0,0,0,0,0,0
CLARK3833,1,3,0,166,0,12,198,4,376
CLARK3834,6,6,4,475,0,14,235,12,728
CLARK3841,11,11,4,826,4,25,235,22,1094
CLARK3842,6,6,6,505,1,23,231,12,766
CLARK3843,6,10,2,703,6,42,288,16,1041
CLARK3844,5,4,1,386,1,26,217,9,631
CLARK3845,0,0,1,50,0,6,78,0,135
CLARK3851,1,0,0,0,0,0,0,1,0
CLARK3852,1,1,0,71,0,7,100,2,178
CLARK3853,1,0,0,21,0,1,22,1,44
CLARK3854,6,5,5,437,2,23,255,11,722
CLARK3855,14,5,2,779,5,23,248,19,1057
CLARK3863,4,4,1,386,3,23,282,8,695
CLARK3864,7,6,10,587,3,34,411,13,1045
CLARK3866,2,1,0,120,0,10,142,3,272
CLARK4017,18,0,3,652,1,3,31,18,690
CLARK4028,18,0,3,608,0,12,17,18,640
CLARK4066,0,1,0,42,0,1,5,1,48
CLARK4069,1,0,0,61,0,3,13,1,77
CLARK4073,0,0,0,12,0,0,10,0,22
CLARK4076,0,1,0,0,0,0,0,1,0
CLARK4304,10,6,3,688,3,22,205,16,921
CLARK4305,12,7,5,857,0,31,187,19,1080
CLARK4306,13,6,1,842,0,13,161,19,1017
CLARK4307,12,6,2,713,1,26,202,18,944
CLARK4309,12,3,3,549,2,11,59,15,624
CLARK4310,16,0,2,579,2,6,30,16,619
CLARK4381,7,2,4,378,3,11,76,9,472
CLARK4384,7,4,3,443,3,15,117,11,581
CLARK4387,13,8,5,834,7,18,120,21,984
CLARK4415,5,3,3,320,1,5,27,8,356
CLARK4434,0,1,0,30,0,4,46,1,80
CLARK4454,0,0,0,0,0,0,0,0,0
CLARK4461,20,2,4,775,1,8,64,22,852
CLARK4463,0,1,0,43,0,0,11,1,54
CLARK4467,15,0,2,411,0,5,17,15,435
CLARK4500,4,3,3,377,2,8,150,7,540
CLARK4501,11,6,2,715,2,46,469,17,1234
CLARK4502,4,6,2,458,0,24,230,10,714
CLARK4504,12,11,6,947,5,35,304,23,1297
CLARK4505,6,6,8,551,2,25,238,12,824
CLARK4506,9,3,3,528,3,32,276,12,842
CLARK4507,15,7,4,858,4,14,122,22,1002
CLARK4508,14,0,2,472,2,6,28,14,510
CLARK4510,4,13,3,313,5,7,110,17,438
CLARK4512,4,0,1,220,0,4,134,4,359
CLARK4513,4,3,5,243,3,13,158,7,422
CLARK4514,13,4,7,647,6,22,77,17,759
CLARK4522,3,3,2,300,1,7,110,6,420
CLARK4523,5,6,3,457,3,20,94,11,577
CLARK4525,8,6,6,458,1,18,209,14,692
CLARK4526,8,3,2,499,3,9,57,11,570
CLARK4527,17,4,6,832,3,22,123,21,986
CLARK4528,16,7,7,845,0,17,136,23,1005
CLARK4529,7,7,4,530,2,19,74,14,629
CLARK4530,9,4,0,506,6,14,104,13,630
CLARK4531,11,7,4,767,6,22,196,18,995
CLARK4532,7,5,3,465,7,9,91,12,575
CLARK4535,9,8,9,635,4,23,228,17,899
CLARK4536,12,6,5,723,1,17,191,18,937
CLARK4540,5,4,3,347,0,12,107,9,469
CLARK4541,10,4,6,643,1,20,193,14,863
CLARK4543,4,3,7,236,0,6,62,7,311
CLARK4546,6,8,5,427,1,11,109,14,553
CLARK4547,4,3,0,262,0,7,69,7,338
CLARK4548,3,5,0,284,1,11,43,8,339
CLARK4549,5,3,3,342,4,12,53,8,414
CLARK4550,4,3,4,264,1,7,57,7,333
CLARK4551,7,2,5,374,1,12,78,9,470
CLARK4552,8,6,2,592,2,16,105,14,717
CLARK4553,12,6,5,716,5,20,191,18,937
CLARK4554,2,2,1,162,0,1,16,4,180
CLARK4555,9,3,6,509,0,14,107,12,636
CLARK4556,8,5,2,509,1,17,90,13,619
CLARK4557,10,4,1,616,4,16,109,14,746
CLARK4559,12,4,1,595,4,20,98,16,718
CLARK4560,7,1,2,341,2,6,88,8,439
CLARK4561,5,5,3,451,1,12,86,10,553
CLARK4562,4,2,4,244,2,6,90,6,346
CLARK4563,3,4,0,290,2,11,116,7,419
CLARK4564,0,3,0,122,0,3,16,3,141
CLARK4565,10,8,9,822,2,27,208,18,1068
CLARK4566,9,6,7,625,2,15,157,15,806
CLARK4567,15,7,14,944,5,25,168,22,1156
CLARK4568,1,1,0,73,1,1,24,2,99
CLARK4569,6,6,4,489,3,19,97,12,612
CLARK4571,0,1,0,38,0,0,6,1,44
CLARK4573,2,1,2,141,0,7,28,3,178
CLARK4577,12,6,2,772,7,19,163,18,963
CLARK4581,13,7,10,838,7,25,245,20,1125
CLARK4582,5,7,3,563,2,8,199,12,775
CLARK4583,10,4,5,594,1,13,171,14,784
CLARK4584,8,8,9,619,1,19,198,16,846
CLARK4585,8,5,4,473,2,17,141,13,637
CLARK4586,11,9,8,914,4,31,353,20,1310
CLARK4590,6,3,2,293,2,9,39,9,345
CLARK4591,5,2,0,162,0,2,32,7,196
CLARK4592,2,1,0,86,0,1,14,3,101
CLARK4593,5,5,5,333,3,12,44,10,397
CLARK4594,0,0,0,0,0,0,0,0,0
CLARK4596,1,1,0,106,0,1,9,2,116
CLARK4597,14,7,5,762,1,26,67,21,861
CLARK4598,5,7,3,510,1,16,73,12,603
CLARK4599,9,5,0,544,4,15,89,14,652
CLARK4601,1,2,1,45,1,2,29,3,78
CLARK4602,9,7,2,519,6,10,95,16,632
CLARK4603,5,4,4,225,2,10,92,9,333
CLARK4604,2,3,3,165,0,9,63,5,240
CLARK4605,7,12,3,821,1,40,343,19,1208
CLARK4606,0,1,0,47,0,1,8,1,56
CLARK4611,4,5,4,326,3,14,112,9,459
CLARK4612,9,8,6,670,1,36,287,17,1000
CLARK4614,1,3,0,50,0,3,35,4,88
CLARK4616,27,0,3,826,0,9,53,27,891
CLARK4621,4,4,0,376,2,22,451,8,851
CLARK4623,8,7,9,648,4,37,341,15,1039
CLARK4633,6,7,3,547,4,29,304,13,887
CLARK4634,12,9,4,799,4,27,333,21,1167
CLARK4635,7,5,1,359,1,18,168,12,547
CLARK4636,0,1,0,0,0,0,0,1,0
CLARK4641,0,2,0,65,1,2,77,2,145
CLARK4642,4,4,1,378,2,6,92,8,479
CLARK4643,2,4,0,276,3,10,83,6,372
CLARK4650,1,3,1,142,3,3,12,4,161
CLARK4652,11,6,0,655,3,8,93,17,759
CLARK5003,0,4,0,103,1,8,34,4,146
CLARK5029,11,9,6,549,1,21,207,20,784
CLARK5034,7,8,8,583,2,23,231,15,847
CLARK5036,5,5,3,308,0,12,254,10,577
CLARK5047,5,6,2,502,2,33,474,11,1013
CLARK5056,2,6,6,317,4,7,85,8,419
CLARK5323,9,5,6,637,3,24,197,14,867
CLARK5324,7,3,2,453,3,27,319,10,804
CLARK5326,5,3,2,333,1,17,408,8,761
CLARK5330,4,4,1,472,2,21,273,8,769
CLARK5332,4,3,5,257,3,10,89,7,364
CLARK5333,9,4,5,532,4,32,181,13,754
CLARK5350,7,7,1,573,1,26,179,14,780
CLARK5356,3,4,0,234,1,3,90,7,328
CLARK5372,4,8,5,415,1,15,97,12,533
CLARK5384,4,6,2,347,3,10,132,10,494
CLARK5390,4,7,1,272,0,11,177,11,461
CLARK5393,5,3,6,361,0,20,317,8,704
CLARK5394,7,3,2,332,2,14,334,10,684
CLARK5395,3,2,1,178,1,8,221,5,409
CLARK5396,7,3,4,521,0,19,387,10,931
CLARK5397,8,4,1,577,0,23,553,12,1154
CLARK5400,6,4,5,346,0,10,185,10,546
CLARK5403,4,3,4,287,2,15,131,7,439
CLARK5404,12,3,5,647,2,5,241,15,900
CLARK5405,10,9,4,782,3,21,235,19,1045
CLARK5410,7,7,6,557,2,18,247,14,830
CLARK5412,8,7,1,650,4,31,255,15,941
CLARK5413,6,8,7,637,5,26,271,14,946
CLARK5417,6,4,5,471,3,12,187,10,678
CLARK5425,4,6,1,442,3,19,235,10,700
CLARK5430,6,7,3,541,3,26,268,13,841
CLARK5501,3,1,1,151,2,9,155,4,318
CLARK5504,5,4,5,430,3,30,327,9,795
CLARK5505,6,7,4,532,3,25,368,13,932
CLARK5511,4,3,3,301,0,6,136,7,446
CLARK5512,9,4,4,551,1,25,267,13,848
CLARK5513,10,5,8,741,1,26,383,15,1159
CLARK5515,5,1,7,294,2,13,238,6,554
CLARK5521,3,3,6,254,0,19,140,6,419
CLARK5522,6,7,2,598,2,23,206,13,831
CLARK5523,7,3,3,487,2,25,327,10,844
CLARK5524,2,1,0,118,0,22,215,3,355
CLARK5525,2,1,2,107,0,14,194,3,317
CLARK5531,3,1,1,191,1,9,236,4,438
CLARK5532,3,5,2,303,2,27,166,8,500
CLARK5533,7,1,3,366,3,5,160,8,537
CLARK5534,4,3,0,314,0,10,142,7,466
CLARK5535,3,4,0,300,2,15,140,7,457
CLARK5536,6,7,3,578,1,24,253,13,859
CLARK5537,6,8,1,613,4,15,159,14,792
CLARK5541,0,0,2,75,0,2,9,0,88
CLARK5542,4,5,4,387,1,11,106,9,509
CLARK5543,3,4,1,262,2,4,32,7,301
CLARK5544,6,6,1,494,2,19,168,12,684
CLARK5545,12,7,6,728,3,26,451,19,1214
CLARK5552,4,6,3,510,3,18,353,10,887
CLARK5553,4,2,2,348,0,20,250,6,620
CLARK5554,4,4,1,390,1,21,298,8,711
CLARK5555,3,3,2,241,1,13,188,6,445
CLARK5560,4,4,0,394,3,16,272,8,685
CLARK5562,5,5,1,400,1,8,184,10,594
CLARK5564,4,6,2,438,7,28,183,10,658
CLARK5565,8,5,8,528,5,27,231,13,799
CLARK5566,5,4,1,367,1,15,283,9,667
CLARK5567,5,5,3,459,2,25,276,10,765
CLARK5568,4,5,2,408,2,21,353,9,786
CLARK5569,3,5,6,390,1,28,299,8,724
CLARK5570,9,4,6,444,4,12,390,13,856
CLARK5571,8,7,0,505,3,23,247,15,778
CLARK5572,5,7,5,509,6,20,234,12,774
CLARK5573,4,3,0,350,1,17,266,7,634
CLARK5574,2,2,0,155,1,7,135,4,298
CLARK5575,3,2,0,235,1,19,133,5,388
CLARK5576,5,3,1,324,1,32,176,8,534
CLARK5577,5,4,2,372,0,6,185,9,565
CLARK5578,5,3,2,370,3,18,186,8,579
CLARK5579,3,3,0,262,4,10,101,6,377
CLARK5580,11,5,3,538,2,13,172,16,728
CLARK5581,8,13,6,623,3,13,143,21,788
CLARK5582,7,9,5,495,4,20,231,16,755
CLARK5583,6,7,3,399,2,5,133,13,542
CLARK5584,6,8,3,409,1,28,144,14,585
CLARK5585,6,8,4,481,6,29,186,14,706
CLARK5586,7,9,4,529,3,17,216,16,769
CLARK5587,6,4,0,435,1,30,408,10,874
CLARK5588,1,1,1,135,1,5,140,2,282
CLARK5589,1,2,0,144,1,9,167,3,321
CLARK5591,4,3,1,297,2,20,150,7,470
CLARK5592,4,5,5,337,0,20,197,9,559
CLARK5593,6,5,1,437,2,16,190,11,646
CLARK5594,5,3,4,371,2,10,293,8,680
CLARK5595,5,3,3,347,0,15,154,8,519
CLARK5596,11,10,9,702,1,16,192,21,920
CLARK5597,3,3,2,216,0,9,51,6,278
CLARK5598,7,10,2,623,3,28,207,17,863
CLARK5601,7,5,4,507,7,28,347,12,893
CLARK5603,6,6,5,552,6,34,362,12,959
CLARK5604,7,6,7,614,3,42,448,13,1114
CLARK5612,6,2,0,302,1,10,113,8,426
CLARK5613,5,4,3,458,3,17,118,9,599
CLARK5614,5,8,4,371,3,12,66,13,456
CLARK5615,4,1,3,227,2,5,199,5,436
CLARK5616,4,4,1,398,1,27,277,8,704
CLARK5617,9,10,8,904,5,24,244,19,1185
CLARK5620,15,5,8,666,5,28,367,20,1074
CLARK5621,5,4,6,358,2,15,153,9,534
CLARK5622,4,2,0,229,2,11,117,6,359
CLARK5623,8,7,1,581,4,29,259,15,874
CLARK5624,4,4,2,352,1,15,259,8,629
CLARK5625,5,4,6,354,2,27,221,9,610
CLARK5631,3,4,3,308,2,22,189,7,524
CLARK5632,6,7,6,471,4,17,205,13,703
CLARK5633,8,4,2,396,3,17,137,12,555
CLARK5634,3,3,4,259,2,9,117,6,391
CLARK5635,8,9,9,858,6,38,281,17,1192
CLARK5636,6,4,2,378,0,13,228,10,621
CLARK5641,0,1,0,43,0,1,30,1,74
CLARK5642,3,2,1,218,0,4,161,5,384
CLARK5651,6,5,10,787,3,68,981,11,1849
CLARK5652,6,5,3,601,0,43,1008,11,1655
CLARK5653,6,7,5,450,4,51,439,13,949
CLARK5654,3,5,6,307,1,22,258,8,594
CLARK6040,6,3,1,334,1,19,249,9,604
CLARK6057,6,4,3,465,3,19,397,10,887
CLARK6062,4,4,2,366,1,23,250,8,642
CLARK6066,3,4,2,299,0,20,260,7,581
CLARK6109,6,9,1,669,2,32,350,15,1054
CLARK6362,7,3,1,427,4,21,169,10,622
CLARK6424,5,6,3,480,2,22,304,11,811
CLARK6431,5,5,2,436,2,13,305,10,758
CLARK6434,4,2,2,220,6,5,177,6,410
CLARK6440,4,4,5,368,0,20,302,8,695
CLARK6463,5,4,5,456,1,11,276,9,749
CLARK6469,4,6,3,501,2,45,447,10,998
CLARK6470,6,5,2,514,2,18,414,11,950
CLARK6471,6,5,4,565,0,22,358,11,949
CLARK6475,4,7,6,546,3,28,326,11,909
CLARK6477,4,2,0,330,0,21,297,6,648
CLARK6484,0,1,0,0,0,0,0,1,0
CLARK6486,1,0,0,14,0,1,13,1,28
CLARK6487,2,4,6,183,2,21,440,6,652
CLARK6488,0,0,0,21,1,6,50,0,78
CLARK6490,3,1,1,198,2,12,300,4,513
CLARK6492,6,5,5,654,5,36,540,11,1240
CLARK6493,6,2,4,435,3,25,435,8,902
CLARK6494,3,3,0,302,1,20,333,6,656
CLARK6497,7,5,4,605,1,41,605,12,1256
CLARK6498,0,1,2,36,0,6,106,1,150
CLARK6499,8,8,3,1025,4,66,818,16,1916
CLARK6500,1,0,0,17,0,0,9,1,26
CLARK6512,4,2,0,367,1,23,696,6,1087
CLARK6513,2,1,0,187,0,9,288,3,484
CLARK6514,6,4,4,545,2,31,499,10,1081
CLARK6515,4,2,2,312,2,18,399,6,733
CLARK6517,4,5,1,611,0,45,585,9,1242
CLARK6520,4,4,2,409,3,26,427,8,867
CLARK6521,5,4,1,492,2,37,499,9,1031
CLARK6522,2,3,1,304,0,8,431,5,744
CLARK6526,4,1,0,321,0,5,415,5,741
CLARK6527,5,4,12,800,2,74,859,9,1747
CLARK6530,4,5,1,476,0,38,458,9,973
CLARK6531,7,7,11,689,3,33,441,14,1177
CLARK6533,2,5,4,445,2,16,252,7,719
CLARK6538,3,2,3,320,1,26,223,5,573
CLARK6539,4,6,1,496,3,37,441,10,978
CLARK6540,5,7,4,724,4,51,527,12,1310
CLARK6544,4,3,3,351,2,17,411,7,784
CLARK6545,4,3,0,405,0,14,275,7,694
CLARK6547,5,7,7,620,2,46,475,12,1150
CLARK6548,5,5,4,512,2,33,428,10,979
CLARK6549,4,5,2,452,1,36,338,9,829
CLARK6601,6,7,17,543,8,45,501,13,1114
CLARK6602,7,4,3,507,1,31,399,11,941
CLARK6604,6,9,5,685,2,35,386,15,1113
CLARK6605,2,1,0,98,0,0,38,3,136
CLARK6606,7,7,2,545,3,39,239,14,828
CLARK6607,8,4,5,501,5,29,266,12,806
CLARK6608,2,1,0,102,1,7,29,3,139
CLARK6609,4,6,6,577,2,35,406,10,1026
CLARK6610,7,3,2,781,0,58,933,10,1774
CLARK6611,4,2,2,297,1,26,338,6,664
CLARK6612,7,6,3,540,3,25,323,13,894
CLARK6613,2,4,2,273,0,31,311,6,617
CLARK6614,1,0,0,0,0,0,0,1,0
CLARK6615,2,2,1,157,1,13,207,4,379
CLARK6621,5,5,2,468,2,23,379,10,874
CLARK6622,5,8,7,510,4,28,224,13,773
CLARK6625,3,3,0,296,0,25,367,6,688
CLARK6631,3,3,0,285,1,22,310,6,618
CLARK6632,4,3,3,283,1,16,306,7,609
CLARK6633,4,6,4,467,4,26,461,10,962
CLARK6634,4,2,1,306,2,17,436,6,762
CLARK6635,5,3,3,403,1,29,530,8,966
CLARK6642,4,3,2,341,1,36,354,7,734
CLARK6643,5,5,4,474,1,32,394,10,905
CLARK6644,5,6,2,597,1,48,505,11,1153
CLARK6645,6,5,2,582,5,34,493,11,1116
CLARK6648,3,6,4,501,1,47,309,9,862
CLARK6649,3,7,4,510,2,47,359,10,922
CLARK6651,6,4,10,497,0,35,424,10,966
CLARK6652,3,1,0,236,1,11,340,4,588
CLARK6653,3,5,0,417,1,31,336,8,785
CLARK6654,5,6,2,503,1,40,359,11,905
CLARK6655,5,4,2,453,3,16,488,9,962
CLARK6656,5,3,3,396,1,17,402,8,819
CLARK6657,4,5,3,471,1,26,494,9,995
CLARK6658,6,4,1,597,1,29,569,10,1197
CLARK6661,5,5,1,460,1,46,404,10,912
CLARK6662,3,2,3,284,0,18,370,5,675
CLARK6663,5,3,1,314,1,24,215,8,555
CLARK6664,3,4,2,363,1,12,243,7,621
CLARK6665,6,3,0,415,2,23,461,9,901
CLARK6666,4,6,3,602,2,44,424,10,1075
CLARK6667,3,5,3,417,1,39,420,8,880
CLARK6671,3,4,2,302,2,22,216,7,544
CLARK6672,4,4,0,381,3,20,284,8,688
CLARK6673,8,7,4,705,2,46,534,15,1291
CLARK6674,4,5,4,412,0,13,286,9,715
CLARK6675,5,3,2,366,1,19,384,8,772
CLARK6681,5,4,2,411,0,19,583,9,1015
CLARK6683,1,3,3,199,2,20,307,4,531
CLARK6684,1,3,1,179,0,14,263,4,457
CLARK6685,4,6,5,417,0,18,315,10,755
CLARK6686,5,4,4,410,1,9,219,9,643
CLARK6691,3,4,3,309,3,22,173,7,510
CLARK6692,4,3,0,308,2,19,240,7,569
CLARK6693,7,7,2,671,3,25,427,14,1128
CLARK6694,6,1,2,327,0,21,263,7,613
CLARK6695,6,3,1,468,2,19,303,9,793
CLARK6700,2,1,0,131,0,2,117,3,250
CLARK6701,3,2,4,225,1,12,224,5,466
CLARK6702,4,4,1,392,2,13,269,8,677
CLARK6703,1,5,5,348,0,22,196,6,571
CLARK6704,5,5,1,446,4,21,290,10,762
CLARK6705,4,5,3,360,2,14,128,9,507
CLARK6706,4,5,6,359,2,16,147,9,530
CLARK6707,6,7,2,603,2,31,552,13,1190
CLARK6708,7,4,1,537,3,23,331,11,895
CLARK6709,3,3,3,254,2,14,220,6,493
CLARK6710,10,9,2,757,3,17,273,19,1052
CLARK6712,2,1,2,119,0,12,244,3,377
CLARK6713,1,3,1,152,0,8,120,4,281
CLARK6714,0,2,0,132,0,11,63,2,206
CLARK6715,2,5,2,397,2,22,268,7,691
CLARK6716,3,8,0,602,1,42,521,11,1166
CLARK6719,4,3,5,478,1,22,455,7,961
CLARK6720,1,2,2,187,1,12,181,3,383
CLARK6721,5,3,3,462,1,23,363,8,852
CLARK6722,0,0,0,0,0,0,0,0,0
CLARK6723,1,1,2,92,2,8,58,2,162
CLARK6724,9,8,8,1215,6,53,791,17,2073
CLARK6725,6,6,3,738,4,43,683,12,1471
CLARK6726,5,1,0,306,0,8,546,6,860
CLARK6727,5,1,0,337,1,7,486,6,831
CLARK6728,5,3,6,538,1,28,742,8,1315
CLARK6729,1,3,2,201,1,10,232,4,446
CLARK6730,5,5,4,518,4,29,335,10,890
CLARK6731,4,3,0,405,0,22,403,7,830
CLARK6732,4,4,3,419,2,27,353,8,804
CLARK6733,6,5,7,621,2,35,406,11,1071
CLARK6734,3,4,3,436,0,31,258,7,728
CLARK6735,5,9,4,846,3,64,540,14,1457
CLARK6736,3,3,3,309,0,17,217,6,546
CLARK6737,1,4,0,341,1,17,288,5,647
CLARK6738,5,5,4,490,5,30,384,10,913
CLARK6739,4,5,0,451,2,23,223,9,699
CLARK6751,5,7,3,992,2,50,683,12,1730
CLARK6752,7,7,13,981,5,87,927,14,2013
CLARK7012,4,7,2,515,2,31,224,11,774
CLARK7047,5,4,1,431,2,31,349,9,814
CLARK7048,6,5,3,503,2,26,361,11,895
CLARK7049,4,4,6,371,1,30,242,8,650
CLARK7050,3,5,2,347,1,28,325,8,703
CLARK7054,4,5,4,390,4,25,186,9,609
CLARK7079,9,7,2,612,0,33,193,16,840
CLARK7097,3,9,3,498,6,36,257,12,800
CLARK7311,3,4,2,327,1,20,187,7,537
CLARK7312,6,9,7,627,3,26,187,15,850
CLARK7332,6,6,3,496,3,23,189,12,714
CLARK7334,1,3,0,192,0,12,94,4,298
CLARK7341,4,5,4,394,1,26,155,9,580
CLARK7351,3,4,3,282,2,44,410,7,741
CLARK7352,6,3,4,306,3,28,677,9,1018
CLARK7354,5,4,6,350,1,39,474,9,870
CLARK7355,4,7,4,474,4,42,536,11,1060
CLARK7356,3,2,1,223,2,21,368,5,615
CLARK7357,4,8,10,402,4,39,438,12,893
CLARK7358,1,2,1,126,0,14,125,3,266
CLARK7359,8,4,7,462,1,42,495,12,1007
CLARK7360,5,2,7,235,1,35,426,7,704
CLARK7361,2,2,5,157,0,13,320,4,495
CLARK7366,5,3,2,302,0,36,246,8,586
CLARK7387,4,6,4,371,1,29,225,10,630
CLARK7395,5,5,2,448,3,29,311,10,793
CLARK7402,4,6,11,436,1,34,348,10,830
CLARK7403,7,4,2,504,2,29,445,11,982
CLARK7405,5,5,7,521,3,38,574,10,1143
CLARK7410,4,4,4,413,1,39,474,8,931
CLARK7411,6,6,1,577,5,29,469,12,1081
CLARK7413,5,6,5,596,2,31,568,11,1202
CLARK7414,4,4,3,464,2,24,432,8,925
CLARK7415,6,5,4,522,5,43,491,11,1065
CLARK7416,3,3,3,337,2,25,245,6,612
CLARK7417,1,4,1,375,7,32,226,5,641
CLARK7422,9,6,9,664,2,51,559,15,1285
CLARK7430,7,7,7,440,1,31,436,14,915
CLARK7500,6,9,14,695,2,46,549,15,1306
CLARK7501,2,1,1,78,0,3,55,3,137
CLARK7502,3,7,0,467,4,16,322,10,809
CLARK7503,1,5,3,217,0,23,111,6,354
CLARK7504,0,1,0,58,0,2,35,1,95
CLARK7506,5,2,2,273,0,9,116,7,400
CLARK7507,8,6,2,644,6,26,330,14,1008
CLARK7508,2,3,1,228,5,16,123,5,373
CLARK7509,3,9,1,476,1,30,176,12,684
CLARK7511,0,1,0,0,0,0,0,1,0
CLARK7512,3,4,1,287,0,9,168,7,465
CLARK7513,10,8,7,792,2,32,334,18,1167
CLARK7515,10,3,4,522,3,21,427,13,977
CLARK7521,0,1,0,12,0,0,5,1,17
CLARK7522,8,11,5,1014,6,52,415,19,1492
CLARK7523,1,0,2,73,0,3,38,1,116
CLARK7524,5,6,4,392,2,24,230,11,652
CLARK7525,8,5,2,342,5,14,149,13,512
CLARK7526,1,4,2,239,2,13,133,5,389
CLARK7527,3,5,2,313,1,26,216,8,558
CLARK7528,6,8,6,662,1,47,281,14,997
CLARK7529,2,6,1,373,1,35,213,8,623
CLARK7530,3,6,1,350,0,32,270,9,653
CLARK7531,6,6,9,488,6,20,208,12,731
CLARK7532,5,5,4,448,4,18,215,10,689
CLARK7534,3,2,2,365,0,28,936,5,1331
CLARK7536,3,3,1,232,4,17,593,6,847
CLARK7542,1,0,0,9,0,1,14,1,24
CLARK7545,3,3,3,295,2,22,639,6,961
CLARK7550,0,1,0,16,0,4,24,1,44
CLARK7551,3,2,1,184,1,15,616,5,817
CLARK7552,4,2,1,274,0,22,592,6,889
CLARK7553,3,4,5,303,0,35,429,7,772
CLARK7554,3,3,6,267,3,21,341,6,638
CLARK7555,4,5,8,371,3,60,658,9,1100
CLARK7561,2,4,2,260,1,44,583,6,890
CLARK7562,2,4,2,262,1,47,557,6,869
CLARK7563,2,2,3,179,2,20,433,4,637
CLARK7564,4,1,5,197,2,20,457,5,681
CLARK7569,6,7,3,525,1,38,494,13,1061
CLARK7570,3,6,3,284,1,33,308,9,629
CLARK7571,4,4,5,328,3,26,249,8,611
CLARK7572,4,5,1,355,1,28,318,9,703
CLARK7573,4,5,10,405,5,27,555,9,1002
CLARK7574,4,4,4,379,2,25,507,8,917
CLARK7575,2,2,2,162,0,11,319,4,494
CLARK7581,5,4,6,388,3,42,709,9,1148
CLARK7582,8,4,2,503,1,51,604,12,1161
CLARK7583,4,6,5,397,1,51,687,10,1141
CLARK7584,3,4,5,243,1,23,482,7,754
CLARK7585,3,3,3,233,1,27,616,6,880
CLARK7590,1,1,5,68,0,7,90,2,170
CLARK7591,3,3,4,287,1,28,404,6,724
CLARK7592,3,4,5,316,0,30,356,7,707
CLARK7593,6,5,7,442,5,52,827,11,1333
CLARK7594,5,8,13,604,3,66,1027,13,1713
CLARK7595,1,1,3,81,0,5,272,2,361
CLARK7601,2,5,6,344,3,37,661,7,1051
CLARK7602,6,4,4,445,1,50,770,10,1270
CLARK7603,4,6,8,465,3,51,918,10,1445
CLARK7604,4,4,2,354,0,27,533,8,916
CLARK7605,4,6,10,424,2,51,663,10,1150
CLARK7611,4,2,5,287,2,31,521,6,846
CLARK7612,1,2,1,223,1,19,227,3,471
CLARK7613,5,2,6,313,0,16,421,7,756
CLARK7614,3,5,7,377,1,28,325,8,738
CLARK7615,5,5,5,604,3,43,695,10,1350
CLARK7622,3,2,4,222,2,15,236,5,479
CLARK7623,5,5,7,471,3,32,550,10,1063
CLARK7624,3,5,2,471,4,42,387,8,906
CLARK7625,3,3,3,262,1,19,258,6,543
CLARK7631,6,3,3,524,2,46,679,9,1254
CLARK7632,3,3,2,356,2,28,339,6,727
CLARK7633,4,3,1,410,1,30,427,7,869
CLARK7634,2,2,2,251,1,16,288,4,558
CLARK7635,3,3,1,381,0,18,354,6,754
CLARK7641,5,1,0,346,2,9,453,6,810
CLARK7642,6,0,3,285,0,5,378,6,671
CLARK7643,3,1,1,237,0,14,241,4,493
CLARK7644,4,3,1,424,0,38,494,7,957
CLARK7645,1,2,1,179,1,9,160,3,350
CLARK7651,9,4,2,728,4,35,761,13,1530
CLARK7652,5,2,1,326,1,31,459,7,818
CLARK7653,3,3,4,258,3,19,421,6,705
CLARK7654,3,4,0,362,1,31,419,7,813
CLARK7661,3,3,5,304,1,18,213,6,541
CLARK7662,4,4,5,421,2,22,388,8,838
CLARK7663,6,4,4,497,2,27,463,10,993
CLARK7664,4,3,1,329,1,8,336,7,675
CLARK7665,5,2,6,356,3,31,359,7,755
CLARK7671,4,1,1,321,0,15,388,5,725
CLARK7672,3,3,2,308,1,19,312,6,642
CLARK7674,1,2,1,140,0,10,169,3,320
CLARK7675,4,3,2,295,1,29,372,7,699
CLARK7681,4,3,2,346,1,29,402,7,780
CLARK7682,3,2,4,279,2,18,244,5,547
CLARK7683,5,4,2,436,0,26,493,9,957
CLARK7684,3,3,6,332,0,19,279,6,636
CLARK7685,5,3,4,401,2,23,337,8,767
CLARK7691,3,1,0,239,0,14,298,4,551
CLARK7692,6,3,1,472,5,38,512,9,1028
CLARK7693,8,4,3,595,3,34,513,12,1148
CLARK7694,6,5,5,502,1,31,513,11,1052
CLARK7695,5,5,6,446,2,38,419,10,911
CLARK7701,1,0,0,52,0,2,35,1,89
CLARK7702,6,5,6,548,2,37,389,11,982
CLARK7703,4,4,0,393,2,22,354,8,771
CLARK7704,2,2,1,211,0,14,214,4,440
CLARK7705,4,3,1,351,1,28,521,7,902
CLARK7706,5,4,5,391,1,20,398,9,815
CLARK7707,4,4,1,374,0,22,346,8,743
CLARK7712,3,3,5,290,0,23,365,6,683
CLARK7713,3,3,3,285,4,15,296,6,603
CLARK7714,3,6,6,387,3,28,261,9,685
CLARK7715,7,7,2,622,2,49,562,14,1237
CLARK7722,3,2,0,288,1,17,316,5,622
CLARK7723,5,4,4,406,2,17,358,9,787
CLARK7724,0,0,0,11,0,0,9,0,20
CLARK7726,4,5,4,489,0,29,321,9,843
CLARK7730,8,6,4,759,4,58,683,14,1508
CLARK7731,4,5,4,448,2,30,403,9,887
CLARK7732,5,5,8,530,3,41,482,10,1064
CLARK7733,4,4,3,387,4,34,432,8,860
CLARK9996,0,0,0,10,0,0,28,0,38
DOUGLAS10,3,2,10,209,0,32,575,5,826
DOUGLAS11,3,2,1,246,2,25,700,5,974
DOUGLAS12,0,2,0,65,0,4,17,2,86
DOUGLAS13,3,3,4,362,2,38,523,6,929
DOUGLAS14,1,2,3,150,2,23,525,3,703
DOUGLAS15,1,1,1,92,1,10,248,2,352
DOUGLAS16,2,1,0,185,1,21,431,3,638
DOUGLAS17,4,2,3,290,5,36,848,6,1182
DOUGLAS18,2,1,4,141,0,29,300,3,474
DOUGLAS19,3,2,6,250,1,37,500,5,794
DOUGLAS20,2,4,5,318,2,50,497,6,872
DOUGLAS21,3,2,2,237,0,15,671,5,925
DOUGLAS22,3,2,4,296,3,42,728,5,1073
DOUGLAS23,2,3,6,264,0,20,428,5,718
DOUGLAS24,1,1,0,86,0,7,287,2,380
DOUGLAS25,3,3,5,345,1,35,774,6,1160
DOUGLAS26,2,1,3,140,3,15,336,3,497
DOUGLAS27,3,1,3,221,0,24,398,4,646
DOUGLAS28,1,0,4,104,0,12,349,1,469
DOUGLAS29,2,1,1,162,1,12,429,3,605
DOUGLAS31,2,2,4,212,1,15,371,4,603
DOUGLAS32,1,1,0,121,1,7,316,2,445
DOUGLAS33,1,2,0,113,1,18,314,3,446
DOUGLAS34,1,1,2,134,0,23,237,2,396
DOUGLAS35,0,1,0,111,0,15,247,1,373
DOUGLAS36,2,0,1,124,0,13,246,2,384
DOUGLAS37,2,1,2,173,0,12,229,3,416
DOUGLAS38,2,1,1,224,0,29,253,3,507
DOUGLAS39,0,2,1,103,0,11,89,2,204
DOUGLAS40,3,2,3,305,1,34,385,5,728
DOUGLAS41,2,3,1,325,2,41,287,5,656
ELKO1,1,2,4,125,8,40,283,3,460
ELKO10,2,2,6,176,1,36,549,4,768
ELKO11,1,2,12,142,1,31,261,3,447
ELKO12,3,2,10,157,2,31,700,5,900
ELKO13,1,0,0,74,2,13,351,1,440
ELKO14,2,2,6,207,3,42,735,4,993
ELKO15,0,2,9,55,5,19,315,2,403
ELKO16,0,2,1,38,2,10,308,2,359
ELKO17,0,1,0,3,0,0,9,1,12
ELKO18,1,0,2,42,2,11,187,1,244
ELKO19,1,0,6,40,0,9,162,1,217
ELKO2,1,2,5,126,2,21,281,3,435
ELKO20,1,3,3,244,5,25,243,4,520
ELKO21,0,1,2,77,0,14,55,1,148
ELKO22,2,2,14,147,0,58,963,4,1182
ELKO23,2,2,9,154,1,44,965,4,1173
ELKO24,2,1,8,81,2,30,610,3,731
ELKO25,1,2,4,92,0,27,561,3,684
ELKO26,1,1,4,77,2,15,427,2,525
ELKO27,0,1,5,34,1,7,256,1,303
ELKO28,0,1,1,12,0,0,72,1,85
ELKO29,0,2,0,76,0,1,25,2,102
ELKO3,1,2,9,115,4,31,315,3,474
ELKO30,0,0,1,0,1,1,44,0,47
ELKO31,1,0,1,9,0,0,27,1,37
ELKO32,1,1,12,58,3,19,592,2,684
ELKO33,1,0,2,14,0,2,84,1,102
ELKO34,0,0,1,15,0,2,108,0,126
ELKO35,0,0,1,5,1,2,90,0,99
ELKO36,1,0,0,18,0,5,84,1,107
ELKO37,0,1,2,7,1,2,75,1,87
ELKO38,1,1,2,81,1,4,77,2,165
ELKO39,0,1,0,12,0,5,88,1,105
ELKO4,1,2,3,122,2,31,308,3,466
ELKO40,1,2,2,126,3,31,861,3,1023
ELKO41,1,2,7,134,2,55,831,3,1029
ELKO5,2,1,6,108,1,25,331,3,471
ELKO6,1,1,6,82,2,33,338,2,461
ELKO7,1,0,11,71,0,28,307,1,417
ELKO8,2,2,6,141,3,33,426,4,609
ELKO9,1,1,4,104,1,35,246,2,390
ESMERALDA1,2,8,0,30,0,8,135,10,173
ESMERALDA2,0,0,2,3,0,0,42,0,47
ESMERALDA3,4,7,1,26,0,6,136,11,169
ESMERALDA4,1,0,0,5,0,1,10,1,16
ESMERALDA5,0,0,0,0,0,0,0,0,0
EUREKA1,1,7,3,27,0,7,272,8,309
EUREKA2,2,3,3,26,0,3,223,5,255
EUREKA3,0,3,0,7,0,5,114,3,126
EUREKA4,0,6,2,14,1,4,114,6,135
HUMBOLDT1,4,4,10,144,1,20,353,8,528
HUMBOLDT10,2,1,0,43,1,2,42,3,88
HUMBOLDT11,0,1,1,18,1,8,177,1,205
HUMBOLDT12,0,1,1,11,0,2,120,1,134
HUMBOLDT13,1,1,6,28,1,17,149,2,201
HUMBOLDT14,1,4,1,73,1,19,421,5,515
HUMBOLDT15,0,3,3,39,1,13,182,3,238
HUMBOLDT2,3,7,8,176,2,34,338,10,558
HUMBOLDT3,3,7,6,157,2,34,330,10,529
HUMBOLDT4,2,7,7,177,3,16,355,9,558
HUMBOLDT5,4,5,8,191,2,53,585,9,839
HUMBOLDT6,4,7,8,176,0,31,672,11,887
HUMBOLDT7,3,4,13,126,0,16,594,7,749
HUMBOLDT8,0,1,1,7,0,1,84,1,93
HUMBOLDT9,0,0,1,15,0,3,111,0,130
LINCOLN1,10,6,7,49,1,13,445,16,515
LINCOLN2,11,14,6,110,0,16,418,25,550
LINCOLN3,0,0,7,32,3,16,374,0,432
LINCOLN4,17,4,5,90,1,16,405,21,517
LINCOLN5,0,1,0,4,0,1,29,1,34
LYON1,2,2,32,1679,11,183,4789,4,6694
LYON10,1,1,2,68,0,9,196,2,275
LYON11,3,2,7,161,2,20,369,5,559
LYON12,1,2,4,221,2,37,553,3,817
LYON13,3,3,3,246,1,31,677,6,958
LYON14,4,3,6,187,0,27,399,7,619
LYON2,2,2,17,965,8,129,2968,4,4087
LYON3,3,2,6,742,6,87,1706,5,2547
LYON4,2,1,22,686,7,98,1518,3,2331
LYON5,0,1,8,294,3,43,841,1,1189
LYON6,4,4,4,198,1,37,345,8,585
LYON7,2,1,10,258,3,53,513,3,837
LYON8,0,1,3,49,0,3,169,1,224
LYON9,2,3,1,78,1,11,159,5,250
MINERAL1,6,2,3,76,3,17,211,8,310
MINERAL11,11,5,1,192,7,11,76,16,287
MINERAL12,2,2,2,35,0,6,109,4,152
MINERAL2,4,6,1,70,1,8,193,10,273
MINERAL3,3,3,2,50,1,8,106,6,167
MINERAL4,3,3,0,40,0,11,101,6,152
MINERAL5,5,4,4,59,2,6,98,9,169
MINERAL6,4,5,6,70,0,15,146,9,237
MINERAL7,1,2,0,19,0,3,51,3,73
MINERAL8,0,0,0,4,0,2,14,0,20
MINERAL9,0,2,0,21,1,1,72,2,95
NYE10,3,2,6,165,0,26,363,5,560
NYE11,5,4,6,302,2,25,589,9,924
NYE12,0,1,1,39,0,19,231,1,290
NYE13,0,0,0,2,0,1,8,0,11
NYE14,3,4,8,150,8,44,658,7,868
NYE15,0,1,0,7,0,2,21,1,30
NYE16,4,4,4,262,3,15,528,8,812
NYE17,4,2,3,196,1,15,539,6,754
NYE18,1,0,1,16,0,1,26,1,44
NYE19,6,4,12,434,2,45,1209,10,1702
NYE20,4,1,3,150,1,14,350,5,518
NYE21,6,5,10,296,4,21,756,11,1087
NYE22,4,2,3,174,1,29,452,6,659
PERSHING1,7,14,9,138,2,18,483,21,650
PERSHING3,16,1,6,97,1,10,227,17,341
PERSHING4,5,9,5,81,3,13,151,14,253
PERSHING5,1,2,1,22,0,7,98,3,128
PERSHING6,1,4,5,64,0,8,305,5,382
PERSHING7,2,3,3,27,0,2,139,5,171
STOREY1,2,6,0,86,2,17,175,8,280
STOREY11,0,0,0,0,0,0,11,0,11
STOREY15,0,0,0,1,0,0,18,0,19
STOREY2,5,5,0,101,0,13,193,10,307
STOREY3,0,0,0,1,0,0,14,0,15
STOREY4,4,7,4,100,1,9,269,11,383
STOREY5,11,9,2,244,0,37,602,20,885
STOREY6,13,11,3,219,3,24,333,24,582
WHITE PINE1,7,7,3,98,3,28,344,14,476
WHITE PINE10,0,3,3,22,0,5,142,3,172
WHITE PINE2,5,6,2,77,1,15,255,11,350
WHITE PINE3,6,7,6,98,4,16,248,13,372
WHITE PINE4,8,5,3,95,3,17,329,13,447
WHITE PINE5,7,10,10,145,0,31,731,17,917
WHITE PINE6,7,6,8,90,1,19,317,13,435
WHITE PINE7,4,0,2,25,0,6,115,4,148
WHITE PINE8,2,1,3,11,2,9,192,3,217
WHITE PINE9,1,1,0,46,0,5,48,2,99
